Genus	Genus
Acorus	Acorus
Alisma	Alisma
Baldellia	Baldellia
Caldesia	Caldesia
Damasonium	Damasonium
Echinodorus	Echinodorus
Hydrocleys	Hydrocleys
Limnocharis	Limnocharis
Luronium	Luronium
Ranalisma	Ranalisma
Sagittaria	Sagittaria
Wiesneria	Wiesneria
Aponogeton	Aponogeton
Aglaonema	Aglaonema
Alocasia	Alocasia
Amorphophallus	Amorphophallus
Anchomanes	Anchomanes
Anthurium	Anthurium
Anubias	Anubias
Ariopsis	Ariopsis
Arisaema	Arisaema
Arisarum	Arisarum
Arum	Arum
Asterostigma	Asterostigma
Bognera	Bognera
Caladium	Caladium
Calla	Calla
Cercestis	Cercestis
Chlorospatha	Chlorospatha
Colocasia	Colocasia
Croatiella	Croatiella
Dieffenbachia	Dieffenbachia
Dracunculus	Dracunculus
Epipremnum	Epipremnum
Filarum	Filarum
Furtadoa	Furtadoa
Gearum	Gearum
Gonatopus	Gonatopus
Gorgonidium	Gorgonidium
Gymnostachys	Gymnostachys
Helicodiceros	Helicodiceros
Heteropsis	Heteropsis
Incarum	Incarum
Landoltia	Landoltia
Lasia	Lasia
Lemna	Lemna
Lysichiton	Lysichiton
Mangonia	Mangonia
Monstera	Monstera
Montrichardia	Montrichardia
Orontium	Orontium
Peltandra	Peltandra
Philodendron	Philodendron
Pinellia	Pinellia
Pistia	Pistia
Pseudodracontium	Pseudodracontium
Remusatia	Remusatia
Rhaphidophora	Rhaphidophora
Scaphispatha	Scaphispatha
Spathantheum	Spathantheum
Spathicarpa	Spathicarpa
Spathiphyllum	Spathiphyllum
Spirodela	Spirodela
Symplocarpus	Symplocarpus
Synandrospadix	Synandrospadix
Syngonium	Syngonium
Taccarum	Taccarum
Typhonium	Typhonium
Wolffia	Wolffia
Wolffiella	Wolffiella
Xanthosoma	Xanthosoma
Zamioculcas	Zamioculcas
Zantedeschia	Zantedeschia
Butomus	Butomus
Amphibolis	Amphibolis
Cymodocea	Cymodocea
Halodule	Halodule
Syringodium	Syringodium
Thalassodendron	Thalassodendron
Blyxa	Blyxa
Egeria	Egeria
Elodea	Elodea
Enhalus	Enhalus
Halophila	Halophila
Hydrilla	Hydrilla
Hydrocharis	Hydrocharis
Lagarosiphon	Lagarosiphon
Limnobium	Limnobium
Najas	Najas
Nechamandra	Nechamandra
Ottelia	Ottelia
Stratiotes	Stratiotes
Thalassia	Thalassia
Vallisneria	Vallisneria
Cycnogeton	Cycnogeton
Lilaea	Lilaea
Tetroncium	Tetroncium
Triglochin	Triglochin
Posidonia	Posidonia
Groenlandia	Groenlandia
Lepilaena	Lepilaena
Potamogeton	Potamogeton
Stuckenia	Stuckenia
Zannichellia	Zannichellia
Ruppia	Ruppia
Scheuchzeria	Scheuchzeria
Harperocallis	Harperocallis
Pleea	Pleea
Tofieldia	Tofieldia
Triantha	Triantha
Phyllospadix	Phyllospadix
Zostera	Zostera
Amborella	Amborella
Aciphylla	Aciphylla
Actinolema	Actinolema
Actinotus	Actinotus
Aegopodium	Aegopodium
Aethusa	Aethusa
Afrocarum	Afrocarum
Agrocharis	Agrocharis
Alepidea	Alepidea
Aletes	Aletes
Ammi	Ammi
Ammoides	Ammoides
Anethum	Anethum
Angelica	Angelica
Anginon	Anginon
Anisosciadium	Anisosciadium
Anisotome	Anisotome
Annesorhiza	Annesorhiza
Anthriscus	Anthriscus
Apiopetalum	Apiopetalum
Apium	Apium
Arctopus	Arctopus
Arracacia	Arracacia
Asteriscium	Asteriscium
Astrantia	Astrantia
Astrodaucus	Astrodaucus
Azorella	Azorella
Berula	Berula
Bifora	Bifora
Bolax	Bolax
Bowlesia	Bowlesia
Bupleurum	Bupleurum
Capnophyllum	Capnophyllum
Carum	Carum
Caucalis	Caucalis
Centella	Centella
Chaerophyllum	Chaerophyllum
Chamaele	Chamaele
Chamaesciadium	Chamaesciadium
Changium	Changium
Cicuta	Cicuta
Cnidium	Cnidium
Conioselinum	Conioselinum
Conium	Conium
Coriandrum	Coriandrum
Crithmum	Crithmum
Cryptotaenia	Cryptotaenia
Cuminum	Cuminum
Cyclospermum	Cyclospermum
Cymopterus	Cymopterus
Cynosciadium	Cynosciadium
Dasispermum	Dasispermum
Daucus	Daucus
Deverra	Deverra
Dichosciadium	Dichosciadium
Diplaspis	Diplaspis
Diposis	Diposis
Distichoselinum	Distichoselinum
Donnellsmithia	Donnellsmithia
Drusa	Drusa
Ducrosia	Ducrosia
Endressia	Endressia
Eremocharis	Eremocharis
Eryngium	Eryngium
Ezosciadium	Ezosciadium
Falcaria	Falcaria
Ferula	Ferula
Foeniculum	Foeniculum
Frommia	Frommia
Gingidia	Gingidia
Glehnia	Glehnia
Glia	Glia
Gymnophyton	Gymnophyton
Hansenia	Hansenia
Harbouria	Harbouria
Heracleum	Heracleum
Hermas	Hermas
Heteromorpha	Heteromorpha
Homalocarpus	Homalocarpus
Johreniopsis	Johreniopsis
Klotzschia	Klotzschia
Lagoecia	Lagoecia
Laretia	Laretia
Laserpitium	Laserpitium
Lefebvrea	Lefebvrea
Levisticum	Levisticum
Lichtensteinia	Lichtensteinia
Lignocarpa	Lignocarpa
Ligusticum	Ligusticum
Lilaeopsis	Lilaeopsis
Limnosciadium	Limnosciadium
Lomatium	Lomatium
Mackinlaya	Mackinlaya
Magydaris	Magydaris
Malabaila	Malabaila
Melanoselinum	Melanoselinum
Meum	Meum
Micropleura	Micropleura
Mulinum	Mulinum
Museniopsis	Museniopsis
Musineon	Musineon
Myrrhidendron	Myrrhidendron
Myrrhis	Myrrhis
Neogoezia	Neogoezia
Notobubon	Notobubon
Oenanthe	Oenanthe
Opopanax	Opopanax
Oreomyrrhis	Oreomyrrhis
Oreoxis	Oreoxis
Orlaya	Orlaya
Orogenia	Orogenia
Oschatzia	Oschatzia
Osmorhiza	Osmorhiza
Ostericum	Ostericum
Oxypolis	Oxypolis
Pastinaca	Pastinaca
Perideridia	Perideridia
Petroselinum	Petroselinum
Peucedanum	Peucedanum
Physospermum	Physospermum
Pimpinella	Pimpinella
Platysace	Platysace
Pleurospermum	Pleurospermum
Polemanniopsis	Polemanniopsis
Polytaenia	Polytaenia
Pozoa	Pozoa
Prangos	Prangos
Pseudocymopterus	Pseudocymopterus
Pseudorlaya	Pseudorlaya
Pternopetalum	Pternopetalum
Ptilimnium	Ptilimnium
Ridolfia	Ridolfia
Sanicula	Sanicula
Saposhnikovia	Saposhnikovia
Scandia	Scandia
Scandix	Scandix
Schizeilema	Schizeilema
Selinum	Selinum
Seseli	Seseli
Silaum	Silaum
Sium	Sium
Smyrnium	Smyrnium
Spananthe	Spananthe
Sphenosciadium	Sphenosciadium
Spuriopimpinella	Spuriopimpinella
Steganotaenia	Steganotaenia
Stilbocarpa	Stilbocarpa
Stoibrax	Stoibrax
Taenidia	Taenidia
Tauschia	Tauschia
Thapsia	Thapsia
Thaspium	Thaspium
Tilingia	Tilingia
Tordylium	Tordylium
Torilis	Torilis
Trachyspermum	Trachyspermum
Trepocarpus	Trepocarpus
Xanthosia	Xanthosia
Zizia	Zizia
Zosima	Zosima
Aralia	Aralia
Arthrophyllum	Arthrophyllum
Astrotricha	Astrotricha
Brassaiopsis	Brassaiopsis
Cephalaralia	Cephalaralia
Cheirodendron	Cheirodendron
Chengiopanax	Chengiopanax
Cuphocarpus	Cuphocarpus
Cussonia	Cussonia
Dendropanax	Dendropanax
Eleutherococcus	Eleutherococcus
Fatsia	Fatsia
Gamblea	Gamblea
Gastonia	Gastonia
Hedera	Hedera
Heteropanax	Heteropanax
Hydrocotyle	Hydrocotyle
Kalopanax	Kalopanax
Macropanax	Macropanax
Meryta	Meryta
Metapanax	Metapanax
Munroidendron	Munroidendron
Neopanax	Neopanax
Oplopanax	Oplopanax
Oreopanax	Oreopanax
Osmoxylon	Osmoxylon
Panax	Panax
Polyscias	Polyscias
Pseudopanax	Pseudopanax
Raukaua	Raukaua
Reynoldsia	Reynoldsia
Schefflera	Schefflera
Sciadodendron	Sciadodendron
Tetrapanax	Tetrapanax
Tetraplasandra	Tetraplasandra
Trachymene	Trachymene
Trevesia	Trevesia
Griselinia	Griselinia
Delarbrea	Delarbrea
Myodocarpus	Myodocarpus
Pennantia	Pennantia
Bentleya	Bentleya
Billardiera	Billardiera
Bursaria	Bursaria
Cheiranthera	Cheiranthera
Citriobatus	Citriobatus
Hymenosporum	Hymenosporum
Marianthus	Marianthus
Pittosporum	Pittosporum
Rhytidosporum	Rhytidosporum
Aralidium	Aralidium
Melanophylla	Melanophylla
Torricellia	Torricellia
Ilex	Ilex
Cardiopteris	Cardiopteris
Helwingia	Helwingia
Phyllonoma	Phyllonoma
Gomphandra	Gomphandra
Medusanthera	Medusanthera
Agathis	Agathis
Araucaria	Araucaria
Wollemia	Wollemia
Acmopyle	Acmopyle
Afrocarpus	Afrocarpus
Dacrycarpus	Dacrycarpus
Dacrydium	Dacrydium
Falcatifolium	Falcatifolium
Halocarpus	Halocarpus
Lagarostrobos	Lagarostrobos
Lepidothamnus	Lepidothamnus
Manoao	Manoao
Microcachrys	Microcachrys
Microstrobos	Microstrobos
Nageia	Nageia
Parasitaxus	Parasitaxus
Phyllocladus	Phyllocladus
Podocarpus	Podocarpus
Prumnopitys	Prumnopitys
Retrophyllum	Retrophyllum
Saxegothaea	Saxegothaea
Sundacarpus	Sundacarpus
Acanthophoenix	Acanthophoenix
Acoelorraphe	Acoelorraphe
Acrocomia	Acrocomia
Actinokentia	Actinokentia
Actinorhytis	Actinorhytis
Adonidia	Adonidia
Aiphanes	Aiphanes
Allagoptera	Allagoptera
Ammandra	Ammandra
Aphandra	Aphandra
Archontophoenix	Archontophoenix
Areca	Areca
Arenga	Arenga
Asterogyne	Asterogyne
Astrocaryum	Astrocaryum
Attalea	Attalea
Bactris	Bactris
Balaka	Balaka
Barcella	Barcella
Basselinia	Basselinia
Beccariophoenix	Beccariophoenix
Bentinckia	Bentinckia
Bismarckia	Bismarckia
Borassodendron	Borassodendron
Borassus	Borassus
Brahea	Brahea
Brassiophoenix	Brassiophoenix
Burretiokentia	Burretiokentia
Butia	Butia
Calamus	Calamus
Calyptrocalyx	Calyptrocalyx
Calyptrogyne	Calyptrogyne
Calyptronoma	Calyptronoma
Carpentaria	Carpentaria
Carpoxylon	Carpoxylon
Caryota	Caryota
Ceroxylon	Ceroxylon
Chamaedorea	Chamaedorea
Chamaerops	Chamaerops
Chambeyronia	Chambeyronia
Chelyocarpus	Chelyocarpus
Chuniophoenix	Chuniophoenix
Clinosperma	Clinosperma
Clinostigma	Clinostigma
Coccothrinax	Coccothrinax
Cocos	Cocos
Colpothrinax	Colpothrinax
Copernicia	Copernicia
Corypha	Corypha
Cryosophila	Cryosophila
Cyphokentia	Cyphokentia
Cyphophoenix	Cyphophoenix
Cyphosperma	Cyphosperma
Cyrtostachys	Cyrtostachys
Desmoncus	Desmoncus
Dictyocaryum	Dictyocaryum
Dictyosperma	Dictyosperma
Dransfieldia	Dransfieldia
Drymophloeus	Drymophloeus
Dypsis	Dypsis
Elaeis	Elaeis
Eremospatha	Eremospatha
Eugeissona	Eugeissona
Euterpe	Euterpe
Gaussia	Gaussia
Geonoma	Geonoma
Guihaia	Guihaia
Hedyscepe	Hedyscepe
Hemithrinax	Hemithrinax
Heterospathe	Heterospathe
Howea	Howea
Hydriastele	Hydriastele
Hyophorbe	Hyophorbe
Hyospathe	Hyospathe
Hyphaene	Hyphaene
Iguanura	Iguanura
Iriartea	Iriartea
Iriartella	Iriartella
Itaya	Itaya
Johannesteijsmannia	Johannesteijsmannia
Juania	Juania
Jubaea	Jubaea
Jubaeopsis	Jubaeopsis
Kentiopsis	Kentiopsis
Kerriodoxa	Kerriodoxa
Korthalsia	Korthalsia
Laccospadix	Laccospadix
Laccosperma	Laccosperma
Latania	Latania
Lemurophoenix	Lemurophoenix
Leopoldinia	Leopoldinia
Lepidocaryum	Lepidocaryum
Lepidorrhachis	Lepidorrhachis
Leucothrinax	Leucothrinax
Licuala	Licuala
Linospadix	Linospadix
Livistona	Livistona
Lodoicea	Lodoicea
Lytocaryum	Lytocaryum
Manicaria	Manicaria
Marojejya	Marojejya
Masoala	Masoala
Mauritia	Mauritia
Mauritiella	Mauritiella
Medemia	Medemia
Metroxylon	Metroxylon
Nannorrhops	Nannorrhops
Nenga	Nenga
Neonicholsonia	Neonicholsonia
Neoveitchia	Neoveitchia
Normanbya	Normanbya
Nypa	Nypa
Oenocarpus	Oenocarpus
Oncocalamus	Oncocalamus
Oncosperma	Oncosperma
Orania	Orania
Oraniopsis	Oraniopsis
Orbignya	Orbignya
Parajubaea	Parajubaea
Phoenicophorium	Phoenicophorium
Phoenix	Phoenix
Pholidocarpus	Pholidocarpus
Pholidostachys	Pholidostachys
Physokentia	Physokentia
Phytelephas	Phytelephas
Pinanga	Pinanga
Plectocomia	Plectocomia
Podococcus	Podococcus
Ponapea	Ponapea
Prestoea	Prestoea
Pritchardia	Pritchardia
Pseudophoenix	Pseudophoenix
Ptychococcus	Ptychococcus
Ptychosperma	Ptychosperma
Raphia	Raphia
Ravenea	Ravenea
Reinhardtia	Reinhardtia
Rhapidophyllum	Rhapidophyllum
Rhapis	Rhapis
Rhopalostylis	Rhopalostylis
Roscheria	Roscheria
Roystonea	Roystonea
Sabal	Sabal
Salacca	Salacca
Satakentia	Satakentia
Satranala	Satranala
Schippia	Schippia
Sclerosperma	Sclerosperma
Serenoa	Serenoa
Socratea	Socratea
Syagrus	Syagrus
Synechanthus	Synechanthus
Tectiphiala	Tectiphiala
Thrinax	Thrinax
Trachycarpus	Trachycarpus
Trithrinax	Trithrinax
Veitchia	Veitchia
Voanioala	Voanioala
Wallichia	Wallichia
Washingtonia	Washingtonia
Welfia	Welfia
Wendlandiella	Wendlandiella
Wettinia	Wettinia
Wodyetia	Wodyetia
Zombia	Zombia
Calectasia	Calectasia
Dasypogon	Dasypogon
Kingia	Kingia
Acis	Acis
Agapanthus	Agapanthus
Allium	Allium
Amaryllis	Amaryllis
Apodolirion	Apodolirion
Boophone	Boophone
Brunsvigia	Brunsvigia
Caliphruria	Caliphruria
Calostemma	Calostemma
Chlidanthus	Chlidanthus
Clinanthus	Clinanthus
Clivia	Clivia
Crinum	Crinum
Cryptostephanus	Cryptostephanus
Cyrtanthus	Cyrtanthus
Eucharis	Eucharis
Eucrosia	Eucrosia
Eustephia	Eustephia
Galanthus	Galanthus
Gethyllis	Gethyllis
Gilliesia	Gilliesia
Griffinia	Griffinia
Habranthus	Habranthus
Haemanthus	Haemanthus
Hannonia	Hannonia
Hessea	Hessea
Hieronymiella	Hieronymiella
Hippeastrum	Hippeastrum
Hymenocallis	Hymenocallis
Ipheion	Ipheion
Ismene	Ismene
Lapiedra	Lapiedra
Leopoldia	Leopoldia
Leptochiton	Leptochiton
Leucocoryne	Leucocoryne
Leucojum	Leucojum
Lycoris	Lycoris
Narcissus	Narcissus
Nerine	Nerine
Nothoscordum	Nothoscordum
Pamianthe	Pamianthe
Pancratium	Pancratium
Paramongaia	Paramongaia
Phaedranassa	Phaedranassa
Phycella	Phycella
Placea	Placea
Proiphys	Proiphys
Rauhia	Rauhia
Rhodophiala	Rhodophiala
Scadoxus	Scadoxus
Solaria	Solaria
Sprekelia	Sprekelia
Stenomesson	Stenomesson
Sternbergia	Sternbergia
Strumaria	Strumaria
Traubia	Traubia
Tristagma	Tristagma
Tulbaghia	Tulbaghia
Ungernia	Ungernia
Vagaria	Vagaria
Worsleya	Worsleya
Zephyranthes	Zephyranthes
Acanthocarpus	Acanthocarpus
Agave	Agave
Albuca	Albuca
Androstephium	Androstephium
Anemarrhena	Anemarrhena
Anthericum	Anthericum
Aphyllanthes	Aphyllanthes
Arthropodium	Arthropodium
Asparagus	Asparagus
Aspidistra	Aspidistra
Battandiera	Battandiera
Beaucarnea	Beaucarnea
Behnia	Behnia
Bessera	Bessera
Bloomeria	Bloomeria
Bowiea	Bowiea
Brimeura	Brimeura
Brodiaea	Brodiaea
Calibanus	Calibanus
Camassia	Camassia
Campylandra	Campylandra
Charybdis	Charybdis
Chlorogalum	Chlorogalum
Chlorophytum	Chlorophytum
Convallaria	Convallaria
Cordyline	Cordyline
Danae	Danae
Dandya	Dandya
Dasylirion	Dasylirion
Daubenya	Daubenya
Dichelostemma	Dichelostemma
Dipcadi	Dipcadi
Disporopsis	Disporopsis
Dracaena	Dracaena
Drimia	Drimia
Eriospermum	Eriospermum
Eucomis	Eucomis
Eustrephus	Eustrephus
Furcraea	Furcraea
Galtonia	Galtonia
Herreria	Herreria
Hesperaloe	Hesperaloe
Hesperocallis	Hesperocallis
Hesperoyucca	Hesperoyucca
Heteropolygonatum	Heteropolygonatum
Hosta	Hosta
Hyacinthella	Hyacinthella
Hyacinthoides	Hyacinthoides
Hyacinthus	Hyacinthus
Lachenalia	Lachenalia
Ledebouria	Ledebouria
Leucocrinum	Leucocrinum
Liriope	Liriope
Lomandra	Lomandra
Maianthemum	Maianthemum
Manfreda	Manfreda
Massonia	Massonia
Merwilla	Merwilla
Muilla	Muilla
Muscari	Muscari
Nectaroscilla	Nectaroscilla
Nolina	Nolina
Ophiopogon	Ophiopogon
Ornithogalum	Ornithogalum
Othocallis	Othocallis
Oziroe	Oziroe
Peliosanthes	Peliosanthes
Polianthes	Polianthes
Polygonatum	Polygonatum
Prochnyanthes	Prochnyanthes
Prospero	Prospero
Pseudogaltonia	Pseudogaltonia
Pseudoprospero	Pseudoprospero
Puschkinia	Puschkinia
Reineckea	Reineckea
Resnova	Resnova
Rohdea	Rohdea
Ruscus	Ruscus
Sansevieria	Sansevieria
Schizocarphus	Schizocarphus
Scilla	Scilla
Semele	Semele
Sowerbaea	Sowerbaea
Speirantha	Speirantha
Spetaea	Spetaea
Thysanotus	Thysanotus
Triteleia	Triteleia
Triteleiopsis	Triteleiopsis
Tupistra	Tupistra
Veltheimia	Veltheimia
Xerolirion	Xerolirion
Yucca	Yucca
Astelia	Astelia
Collospermum	Collospermum
Milligania	Milligania
Neoastelia	Neoastelia
Blandfordia	Blandfordia
Alania	Alania
Borya	Borya
Doryanthes	Doryanthes
Empodium	Empodium
Hypoxis	Hypoxis
Molineria	Molineria
Pauridia	Pauridia
Rhodohypoxis	Rhodohypoxis
Spiloxene	Spiloxene
Alophia	Alophia
Anomatheca	Anomatheca
Aristea	Aristea
Babiana	Babiana
Bobartia	Bobartia
Calydorea	Calydorea
Chasmanthe	Chasmanthe
Cipura	Cipura
Cobana	Cobana
Crocosmia	Crocosmia
Crocus	Crocus
Cypella	Cypella
Dierama	Dierama
Dietes	Dietes
Duthiastrum	Duthiastrum
Eleutherine	Eleutherine
Ennealophus	Ennealophus
Ferraria	Ferraria
Fosteria	Fosteria
Freesia	Freesia
Geissorhiza	Geissorhiza
Gelasine	Gelasine
Gladiolus	Gladiolus
Herbertia	Herbertia
Hesperantha	Hesperantha
Hesperoxiphion	Hesperoxiphion
Iris	Iris
Isophysis	Isophysis
Ixia	Ixia
Klattia	Klattia
Lapeirousia	Lapeirousia
Libertia	Libertia
Melasphaerula	Melasphaerula
Micranthus	Micranthus
Moraea	Moraea
Nemastylis	Nemastylis
Neomarica	Neomarica
Nivenia	Nivenia
Olsynium	Olsynium
Onira	Onira
Orthrosanthus	Orthrosanthus
Patersonia	Patersonia
Pillansia	Pillansia
Radinosiphon	Radinosiphon
Romulea	Romulea
Savannosiphon	Savannosiphon
Sisyrinchium	Sisyrinchium
Solenomelus	Solenomelus
Sparaxis	Sparaxis
Syringodea	Syringodea
Thereianthus	Thereianthus
Tigridia	Tigridia
Trimezia	Trimezia
Tritonia	Tritonia
Tritoniopsis	Tritoniopsis
Watsonia	Watsonia
Witsenia	Witsenia
Xenoscapa	Xenoscapa
Ixiolirion	Ixiolirion
Lanaria	Lanaria
Aa	Aa
Abdominea	Abdominea
Acampe	Acampe
Acanthephippium	Acanthephippium
Acianthera	Acianthera
Acianthus	Acianthus
Acineta	Acineta
Acostaea	Acostaea
Acriopsis	Acriopsis
Acrorchis	Acrorchis
Ada	Ada
Adenochilus	Adenochilus
Adenoncos	Adenoncos
Aerangis	Aerangis
Aeranthes	Aeranthes
Aerides	Aerides
Aganisia	Aganisia
Agrostophyllum	Agrostophyllum
Alamania	Alamania
Amblostoma	Amblostoma
Amesiella	Amesiella
Amparoa	Amparoa
Anacamptis	Anacamptis
Anathallis	Anathallis
Ancistrochilus	Ancistrochilus
Ancistrorhynchus	Ancistrorhynchus
Andinia	Andinia
Angraecopsis	Angraecopsis
Angraecum	Angraecum
Anguloa	Anguloa
Anoectochilus	Anoectochilus
Ansellia	Ansellia
Anthogonium	Anthogonium
Aplectrum	Aplectrum
Aporostylis	Aporostylis
Apostasia	Apostasia
Appendicula	Appendicula
Arethusa	Arethusa
Arpophyllum	Arpophyllum
Artorima	Artorima
Arundina	Arundina
Ascocentropsis	Ascocentropsis
Ascocentrum	Ascocentrum
Ascochilus	Ascochilus
Aspasia	Aspasia
Barbosella	Barbosella
Barkeria	Barkeria
Bartholina	Bartholina
Basiphyllaea	Basiphyllaea
Batemania	Batemania
Beclardia	Beclardia
Benzingia	Benzingia
Bifrenaria	Bifrenaria
Bletia	Bletia
Bletilla	Bletilla
Bolusiella	Bolusiella
Bonatea	Bonatea
Bothriochilus	Bothriochilus
Brachionidium	Brachionidium
Brachtia	Brachtia
Brachypeza	Brachypeza
Bracisepalum	Bracisepalum
Braemia	Braemia
Brasiliorchis	Brasiliorchis
Brassavola	Brassavola
Brassia	Brassia
Broughtonia	Broughtonia
Brownleea	Brownleea
Bulbophyllum	Bulbophyllum
Cadetia	Cadetia
Caladenia	Caladenia
Calanthe	Calanthe
Caleana	Caleana
Calochilus	Calochilus
Calopogon	Calopogon
Calypso	Calypso
Calyptrochilum	Calyptrochilum
Camaridium	Camaridium
Campylocentrum	Campylocentrum
Capanemia	Capanemia
Catasetum	Catasetum
Cattleya	Cattleya
Caucaea	Caucaea
Caularthron	Caularthron
Cephalanthera	Cephalanthera
Ceratocentron	Ceratocentron
Ceratochilus	Ceratochilus
Ceratostylis	Ceratostylis
Chamaeangis	Chamaeangis
Chaubardia	Chaubardia
Chaubardiella	Chaubardiella
Chelonistele	Chelonistele
Chiloglottis	Chiloglottis
Chiloschista	Chiloschista
Chloraea	Chloraea
Chondrorhyncha	Chondrorhyncha
Chondroscaphe	Chondroscaphe
Christensonella	Christensonella
Christensonia	Christensonia
Chysis	Chysis
Cirrhaea	Cirrhaea
Cischweinfia	Cischweinfia
Cleisocentron	Cleisocentron
Cleisomeria	Cleisomeria
Cleisostoma	Cleisostoma
Cleistes	Cleistes
Clematepistephium	Clematepistephium
Clowesia	Clowesia
Cochleanthes	Cochleanthes
Codonorchis	Codonorchis
Coelia	Coelia
Coeliopsis	Coeliopsis
Coeloglossum	Coeloglossum
Coelogyne	Coelogyne
Coilochilus	Coilochilus
Collabium	Collabium
Comparettia	Comparettia
Constantia	Constantia
Corallorhiza	Corallorhiza
Coryanthes	Coryanthes
Corybas	Corybas
Corycium	Corycium
Corymborkis	Corymborkis
Corysanthes	Corysanthes
Crepidium	Crepidium
Cribbia	Cribbia
Cryptarrhena	Cryptarrhena
Cryptocentrum	Cryptocentrum
Cryptopus	Cryptopus
Cryptopylos	Cryptopylos
Cryptostylis	Cryptostylis
Cuitlauzina	Cuitlauzina
Cyanicula	Cyanicula
Cycnoches	Cycnoches
Cymbidiella	Cymbidiella
Cymbidium	Cymbidium
Cynorkis	Cynorkis
Cypripedium	Cypripedium
Cyrtidiorchis	Cyrtidiorchis
Cyrtochiloides	Cyrtochiloides
Cyrtochilum	Cyrtochilum
Cyrtopodium	Cyrtopodium
Cyrtorchis	Cyrtorchis
Cyrtosia	Cyrtosia
Cyrtostylis	Cyrtostylis
Dactylorhiza	Dactylorhiza
Dendrobium	Dendrobium
Dendrochilum	Dendrochilum
Dendrophylax	Dendrophylax
Diaphananthe	Diaphananthe
Diceratostele	Diceratostele
Dichaea	Dichaea
Dienia	Dienia
Dilomilis	Dilomilis
Dimerandra	Dimerandra
Dimorphorchis	Dimorphorchis
Dinema	Dinema
Diplocaulobium	Diplocaulobium
Diploprora	Diploprora
Disa	Disa
Disperis	Disperis
Diuris	Diuris
Dockrillia	Dockrillia
Domingoa	Domingoa
Dracula	Dracula
Dresslerella	Dresslerella
Dressleria	Dressleria
Dryadella	Dryadella
Drymoanthus	Drymoanthus
Duckeella	Duckeella
Dyakia	Dyakia
Earina	Earina
Eburophyton	Eburophyton
Echinosepala	Echinosepala
Eleorchis	Eleorchis
Eltroplectris	Eltroplectris
Elythranthera	Elythranthera
Embreea	Embreea
Encyclia	Encyclia
Entomophobia	Entomophobia
Epidendrum	Epidendrum
Epigeneium	Epigeneium
Epipactis	Epipactis
Epipogium	Epipogium
Epistephium	Epistephium
Eria	Eria
Eriaxis	Eriaxis
Eriochilus	Eriochilus
Eriopsis	Eriopsis
Erycina	Erycina
Erythrorchis	Erythrorchis
Eulophia	Eulophia
Euryblema	Euryblema
Eurychone	Eurychone
Exalaria	Exalaria
Fernandezia	Fernandezia
Flickingeria	Flickingeria
Frondaria	Frondaria
Galeandra	Galeandra
Galearis	Galearis
Galeottia	Galeottia
Gavilea	Gavilea
Geesinkorchis	Geesinkorchis
Gennaria	Gennaria
Genoplesium	Genoplesium
Glomera	Glomera
Glossodia	Glossodia
Gomesa	Gomesa
Gonatostylis	Gonatostylis
Gongora	Gongora
Goodyera	Goodyera
Govenia	Govenia
Grammatophyllum	Grammatophyllum
Graphorkis	Graphorkis
Grobya	Grobya
Grosourdya	Grosourdya
Guarianthe	Guarianthe
Gunnarella	Gunnarella
Gymnadenia	Gymnadenia
Habenaria	Habenaria
Hagsatera	Hagsatera
Haraella	Haraella
Helcia	Helcia
Helleriella	Helleriella
Heterotaxis	Heterotaxis
Hexalectris	Hexalectris
Himantoglossum	Himantoglossum
Hintonella	Hintonella
Hispaniella	Hispaniella
Hofmeisterella	Hofmeisterella
Holcoglossum	Holcoglossum
Holothrix	Holothrix
Homalopetalum	Homalopetalum
Horichia	Horichia
Houlletia	Houlletia
Huntleya	Huntleya
Hygrochilus	Hygrochilus
Hylaeorchis	Hylaeorchis
Hymenorchis	Hymenorchis
Inti	Inti
Ionopsis	Ionopsis
Isabelia	Isabelia
Isochilus	Isochilus
Isotria	Isotria
Jacquiniella	Jacquiniella
Jumellea	Jumellea
Kefersteinia	Kefersteinia
Kegeliella	Kegeliella
Koellensteinia	Koellensteinia
Lacaena	Lacaena
Laelia	Laelia
Lecanorchis	Lecanorchis
Lemurella	Lemurella
Lemurorchis	Lemurorchis
Lepanthes	Lepanthes
Lepanthopsis	Lepanthopsis
Leporella	Leporella
Leptotes	Leptotes
Liparis	Liparis
Listrostachys	Listrostachys
Lockhartia	Lockhartia
Lueddemannia	Lueddemannia
Lycaste	Lycaste
Lycomormium	Lycomormium
Lyperanthus	Lyperanthus
Macroclinium	Macroclinium
Macropodanthus	Macropodanthus
Malaxis	Malaxis
Malleola	Malleola
Mapinguari	Mapinguari
Masdevallia	Masdevallia
Maxillaria	Maxillaria
Maxillariella	Maxillariella
Megastylis	Megastylis
Meiracyllium	Meiracyllium
Mesoglossum	Mesoglossum
Mesospinidium	Mesospinidium
Mexicoa	Mexicoa
Mexipedium	Mexipedium
Microchilus	Microchilus
Microcoelia	Microcoelia
Microepidendrum	Microepidendrum
Micropera	Micropera
Microsaccus	Microsaccus
Microterangis	Microterangis
Microtis	Microtis
Miltonia	Miltonia
Miltoniopsis	Miltoniopsis
Mormodes	Mormodes
Mormolyca	Mormolyca
Myoxanthus	Myoxanthus
Myrmecophila	Myrmecophila
Mystacidium	Mystacidium
Nabaluia	Nabaluia
Neobathiea	Neobathiea
Neobenthamia	Neobenthamia
Neocogniauxia	Neocogniauxia
Neofinetia	Neofinetia
Neogardneria	Neogardneria
Neogyna	Neogyna
Neolauchea	Neolauchea
Neomoorea	Neomoorea
Neotinea	Neotinea
Neottia	Neottia
Nephelaphyllum	Nephelaphyllum
Nervilia	Nervilia
Neuwiedia	Neuwiedia
Nidema	Nidema
Nothodoritis	Nothodoritis
Notylia	Notylia
Oberonia	Oberonia
Octomeria	Octomeria
Odontoglossum	Odontoglossum
Oeceoclades	Oeceoclades
Oeonia	Oeonia
Oeoniella	Oeoniella
Oestlundia	Oestlundia
Omoea	Omoea
Oncidium	Oncidium
Ophrys	Ophrys
Orchis	Orchis
Orleanesia	Orleanesia
Ornithidium	Ornithidium
Ornithocephalus	Ornithocephalus
Ornithochilus	Ornithochilus
Orthoceras	Orthoceras
Otochilus	Otochilus
Otoglossum	Otoglossum
Otostylis	Otostylis
Pabstia	Pabstia
Pabstiella	Pabstiella
Palmorchis	Palmorchis
Panisea	Panisea
Paphinia	Paphinia
Paphiopedilum	Paphiopedilum
Papilionanthe	Papilionanthe
Paradisanthus	Paradisanthus
Parapteroceras	Parapteroceras
Pelatantheria	Pelatantheria
Peristeria	Peristeria
Pescatoria	Pescatoria
Phaius	Phaius
Phalaenopsis	Phalaenopsis
Phloeophila	Phloeophila
Pholidota	Pholidota
Phragmipedium	Phragmipedium
Phreatia	Phreatia
Phymatidium	Phymatidium
Pityphyllum	Pityphyllum
Platanthera	Platanthera
Platystele	Platystele
Platythelys	Platythelys
Pleione	Pleione
Pleurothallis	Pleurothallis
Pleurothallopsis	Pleurothallopsis
Podangis	Podangis
Podochilus	Podochilus
Pogonia	Pogonia
Polycycnis	Polycycnis
Polystachya	Polystachya
Pomatocalpa	Pomatocalpa
Ponera	Ponera
Ponthieva	Ponthieva
Porroglossum	Porroglossum
Prescottia	Prescottia
Pristiglottis	Pristiglottis
Promenaea	Promenaea
Prosthechea	Prosthechea
Pseuderia	Pseuderia
Pseudolaelia	Pseudolaelia
Pseudorchis	Pseudorchis
Pseudovanilla	Pseudovanilla
Psychilis	Psychilis
Psychopsis	Psychopsis
Pteroceras	Pteroceras
Pterostylis	Pterostylis
Pterygodium	Pterygodium
Pyrorchis	Pyrorchis
Quisqueya	Quisqueya
Rangaeris	Rangaeris
Restrepia	Restrepia
Restrepiella	Restrepiella
Rhetinantha	Rhetinantha
Rhinerrhizopsis	Rhinerrhizopsis
Rhipidoglossum	Rhipidoglossum
Rhizanthella	Rhizanthella
Rhyncholaelia	Rhyncholaelia
Rhynchostele	Rhynchostele
Rhynchostylis	Rhynchostylis
Ridleyella	Ridleyella
Rimacola	Rimacola
Rodriguezia	Rodriguezia
Rodrigueziella	Rodrigueziella
Rudolfiella	Rudolfiella
Saccolabium	Saccolabium
Sarcochilus	Sarcochilus
Sarcoglottis	Sarcoglottis
Sarcoglyphis	Sarcoglyphis
Satyrium	Satyrium
Sauvetrea	Sauvetrea
Scaphosepalum	Scaphosepalum
Scaphyglottis	Scaphyglottis
Schlimmia	Schlimmia
Schoenorchis	Schoenorchis
Scuticaria	Scuticaria
Seidenfadenia	Seidenfadenia
Selenipedium	Selenipedium
Sievekingia	Sievekingia
Sigmatostalix	Sigmatostalix
Smitinandia	Smitinandia
Sobennikoffia	Sobennikoffia
Sobralia	Sobralia
Solenangis	Solenangis
Sophronitella	Sophronitella
Sophronitis	Sophronitis
Soterosanthus	Soterosanthus
Spathoglottis	Spathoglottis
Specklinia	Specklinia
Sphyrarhynchus	Sphyrarhynchus
Spiranthes	Spiranthes
Stanhopea	Stanhopea
Staurochilus	Staurochilus
Stelis	Stelis
Stenia	Stenia
Stenoglottis	Stenoglottis
Stenorrhynchos	Stenorrhynchos
Stichorkis	Stichorkis
Stigmatodactylus	Stigmatodactylus
Systeloglossum	Systeloglossum
Taeniophyllum	Taeniophyllum
Tainia	Tainia
Telipogon	Telipogon
Tetramicra	Tetramicra
Thecostele	Thecostele
Thelasis	Thelasis
Thelymitra	Thelymitra
Thrixspermum	Thrixspermum
Thunia	Thunia
Tipularia	Tipularia
Tolumnia	Tolumnia
Trevoria	Trevoria
Trichocentrum	Trichocentrum
Trichoceros	Trichoceros
Trichoglottis	Trichoglottis
Trichopilia	Trichopilia
Trichosalpinx	Trichosalpinx
Trichotosia	Trichotosia
Tridactyle	Tridactyle
Trigonidium	Trigonidium
Triphora	Triphora
Trisetella	Trisetella
Vanda	Vanda
Vandopsis	Vandopsis
Vanilla	Vanilla
Vasqueziella	Vasqueziella
Ventricularia	Ventricularia
Warczewiczella	Warczewiczella
Warrea	Warrea
Warreopsis	Warreopsis
Wullschlaegelia	Wullschlaegelia
Xerorchis	Xerorchis
Xylobium	Xylobium
Ypsilopus	Ypsilopus
Zelenkoa	Zelenkoa
Zootrophion	Zootrophion
Zygopetalum	Zygopetalum
Zygosepalum	Zygosepalum
Zygostates	Zygostates
Conanthera	Conanthera
Cyanastrum	Cyanastrum
Cyanella	Cyanella
Kabuyea	Kabuyea
Odontostomum	Odontostomum
Tecophilaea	Tecophilaea
Walleria	Walleria
Zephyra	Zephyra
Aloe	Aloe
Asphodeline	Asphodeline
Asphodelus	Asphodelus
Astroloba	Astroloba
Astroworthia	Astroworthia
Bulbine	Bulbine
Bulbinella	Bulbinella
Caesia	Caesia
Chortolirion	Chortolirion
Corynotheca	Corynotheca
Dianella	Dianella
Eremurus	Eremurus
Gasteria	Gasteria
Geitonoplesium	Geitonoplesium
Haworthia	Haworthia
Hemerocallis	Hemerocallis
Herpolirion	Herpolirion
Jodrellia	Jodrellia
Johnsonia	Johnsonia
Kniphofia	Kniphofia
Pasithea	Pasithea
Phormium	Phormium
Simethis	Simethis
Stawellia	Stawellia
Stypandra	Stypandra
Trachyandra	Trachyandra
Xanthorrhoea	Xanthorrhoea
Xeronema	Xeronema
Alseuosmia	Alseuosmia
Crispiloba	Crispiloba
Wittsteinia	Wittsteinia
Corokia	Corokia
Abrotanella	Abrotanella
Acamptopappus	Acamptopappus
Acanthocladium	Acanthocladium
Acantholepis	Acantholepis
Acanthospermum	Acanthospermum
Achillea	Achillea
Achnophora	Achnophora
Achyrachaena	Achyrachaena
Acmella	Acmella
Acomis	Acomis
Acourtia	Acourtia
Acrisione	Acrisione
Actinobole	Actinobole
Actites	Actites
Adenocaulon	Adenocaulon
Adenophyllum	Adenophyllum
Adenostyles	Adenostyles
Aegialophila	Aegialophila
Aetheorhiza	Aetheorhiza
Ageratina	Ageratina
Ageratum	Ageratum
Agnorhiza	Agnorhiza
Agoseris	Agoseris
Ainsliaea	Ainsliaea
Ajania	Ajania
Aldama	Aldama
Alepidocline	Alepidocline
Alfredia	Alfredia
Allagopappus	Allagopappus
Alloispermum	Alloispermum
Almutaster	Almutaster
Alvordia	Alvordia
Amauriopsis	Amauriopsis
Amblyolepis	Amblyolepis
Amblyopappus	Amblyopappus
Ambrosia	Ambrosia
Amellus	Amellus
Ammobium	Ammobium
Amphiachyris	Amphiachyris
Amphiglossa	Amphiglossa
Anacyclus	Anacyclus
Anaphalioides	Anaphalioides
Anaphalis	Anaphalis
Anaxeton	Anaxeton
Andryala	Andryala
Anemocarpa	Anemocarpa
Angelphytum	Angelphytum
Angianthus	Angianthus
Anisocarpus	Anisocarpus
Anisocoma	Anisocoma
Anisopappus	Anisopappus
Antennaria	Antennaria
Anthemis	Anthemis
Anvillea	Anvillea
Apalochlamys	Apalochlamys
Aphanactis	Aphanactis
Aphanostephus	Aphanostephus
Aposeris	Aposeris
Arctium	Arctium
Arctotheca	Arctotheca
Arctotis	Arctotis
Argentipallium	Argentipallium
Argyranthemum	Argyranthemum
Argyrotegium	Argyrotegium
Arnica	Arnica
Arnoglossum	Arnoglossum
Arnoseris	Arnoseris
Arrhenechthites	Arrhenechthites
Artemisia	Artemisia
Asaemia	Asaemia
Aster	Aster
Asteridea	Asteridea
Asteriscus	Asteriscus
Astranthium	Astranthium
Athanasia	Athanasia
Athroisma	Athroisma
Atractylis	Atractylis
Atractylodes	Atractylodes
Austroeupatorium	Austroeupatorium
Austrosynotis	Austrosynotis
Aztecaster	Aztecaster
Baccharis	Baccharis
Baccharoides	Baccharoides
Bahia	Bahia
Bahiopsis	Bahiopsis
Baileya	Baileya
Balduina	Balduina
Balsamorhiza	Balsamorhiza
Baltimora	Baltimora
Barkleyanthus	Barkleyanthus
Barnadesia	Barnadesia
Bebbia	Bebbia
Bedfordia	Bedfordia
Bellida	Bellida
Bellis	Bellis
Bellium	Bellium
Berardia	Berardia
Berkheya	Berkheya
Bidens	Bidens
Bigelowia	Bigelowia
Blainvillea	Blainvillea
Blennosperma	Blennosperma
Blennospora	Blennospora
Blepharipappus	Blepharipappus
Blepharispermum	Blepharispermum
Blumea	Blumea
Boltonia	Boltonia
Bombycilaena	Bombycilaena
Borrichia	Borrichia
Bothriocline	Bothriocline
Brachyclados	Brachyclados
Brachyglottis	Brachyglottis
Brachylaena	Brachylaena
Brachyscome	Brachyscome
Brickellia	Brickellia
Bryomorphe	Bryomorphe
Buphthalmum	Buphthalmum
Caesulia	Caesulia
Calea	Calea
Calendula	Calendula
Callicephalus	Callicephalus
Callilepis	Callilepis
Callistephus	Callistephus
Calocephalus	Calocephalus
Calomeria	Calomeria
Calotis	Calotis
Calycadenia	Calycadenia
Calycoseris	Calycoseris
Calyptocarpus	Calyptocarpus
Camptacra	Camptacra
Canadanthus	Canadanthus
Capelio	Capelio
Cardopatium	Cardopatium
Carduncellus	Carduncellus
Carduus	Carduus
Carlina	Carlina
Carpesium	Carpesium
Carphephorus	Carphephorus
Carramboa	Carramboa
Carthamus	Carthamus
Cassinia	Cassinia
Catananche	Catananche
Celmisia	Celmisia
Centaurea	Centaurea
Centaurothamnus	Centaurothamnus
Centipeda	Centipeda
Cephalipterum	Cephalipterum
Cephalosorus	Cephalosorus
Chaenactis	Chaenactis
Chaetadelpha	Chaetadelpha
Chaetanthera	Chaetanthera
Chaetopappa	Chaetopappa
Chamaechaenactis	Chamaechaenactis
Chamaemelum	Chamaemelum
Chardinia	Chardinia
Cheirolophus	Cheirolophus
Chiliotrichum	Chiliotrichum
Chondrilla	Chondrilla
Chromolaena	Chromolaena
Chromolepis	Chromolepis
Chrysactinia	Chrysactinia
Chrysanthemoides	Chrysanthemoides
Chrysanthemum	Chrysanthemum
Chrysocephalum	Chrysocephalum
Chrysocoma	Chrysocoma
Chrysogonum	Chrysogonum
Chrysophthalmum	Chrysophthalmum
Chrysopsis	Chrysopsis
Chrysothamnus	Chrysothamnus
Chuquiraga	Chuquiraga
Cicerbita	Cicerbita
Cichorium	Cichorium
Cineraria	Cineraria
Cirsium	Cirsium
Clappia	Clappia
Clibadium	Clibadium
Coespeletia	Coespeletia
Commidendrum	Commidendrum
Conoclinium	Conoclinium
Constancea	Constancea
Conyza	Conyza
Coreopsis	Coreopsis
Corethrogyne	Corethrogyne
Corymbium	Corymbium
Cosmos	Cosmos
Cota	Cota
Cotula	Cotula
Coulterella	Coulterella
Cousinia	Cousinia
Craspedia	Craspedia
Crassocephalum	Crassocephalum
Cratystylis	Cratystylis
Cremanthodium	Cremanthodium
Crepis	Crepis
Crocidium	Crocidium
Croptilon	Croptilon
Crupina	Crupina
Culcitium	Culcitium
Cullumia	Cullumia
Cuspidia	Cuspidia
Cyclolepis	Cyclolepis
Cymbonotus	Cymbonotus
Cynara	Cynara
Dahlia	Dahlia
Damnxanthodium	Damnxanthodium
Darwiniothamnus	Darwiniothamnus
Dasyphyllum	Dasyphyllum
Dauresia	Dauresia
Decazesia	Decazesia
Deinandra	Deinandra
Delairea	Delairea
Delilia	Delilia
Dendroseris	Dendroseris
Desmanthodium	Desmanthodium
Diaperia	Diaperia
Dicerothamnus	Dicerothamnus
Dichrocephala	Dichrocephala
Dicoma	Dicoma
Dicranocarpus	Dicranocarpus
Didelta	Didelta
Dielitzia	Dielitzia
Dieteria	Dieteria
Dimeresia	Dimeresia
Dimerostemma	Dimerostemma
Dimorphotheca	Dimorphotheca
Diplostephium	Diplostephium
Disparago	Disparago
Distephanus	Distephanus
Dithyrostegia	Dithyrostegia
Dittrichia	Dittrichia
Doellingeria	Doellingeria
Dolichoglottis	Dolichoglottis
Dolichothrix	Dolichothrix
Dolomiaea	Dolomiaea
Doniophyton	Doniophyton
Doronicum	Doronicum
Dubautia	Dubautia
Dugesia	Dugesia
Duhaldea	Duhaldea
Dymondia	Dymondia
Dyscritothamnus	Dyscritothamnus
Dyssodia	Dyssodia
Eastwoodia	Eastwoodia
Eatonella	Eatonella
Echinacea	Echinacea
Echinops	Echinops
Eclipta	Eclipta
Edmondia	Edmondia
Egletes	Egletes
Elaphandra	Elaphandra
Elephantopus	Elephantopus
Embergeria	Embergeria
Emilia	Emilia
Encelia	Encelia
Enceliopsis	Enceliopsis
Engelmannia	Engelmannia
Enydra	Enydra
Erechtites	Erechtites
Eremothamnus	Eremothamnus
Ericameria	Ericameria
Erigeron	Erigeron
Eriocephalus	Eriocephalus
Eriophyllum	Eriophyllum
Erodiophyllum	Erodiophyllum
Erymophyllum	Erymophyllum
Ethulia	Ethulia
Euchiton	Euchiton
Eupatorium	Eupatorium
Eurybia	Eurybia
Euryops	Euryops
Eutetras	Eutetras
Euthamia	Euthamia
Eutrochium	Eutrochium
Ewartia	Ewartia
Farfugium	Farfugium
Feldstonia	Feldstonia
Felicia	Felicia
Filago	Filago
Fitzwillia	Fitzwillia
Flaveria	Flaveria
Florestina	Florestina
Foveolina	Foveolina
Gaillardia	Gaillardia
Galeana	Galeana
Galinsoga	Galinsoga
Gamochaeta	Gamochaeta
Garuleum	Garuleum
Gazania	Gazania
Geigeria	Geigeria
Geraea	Geraea
Gerbera	Gerbera
Geropogon	Geropogon
Gilberta	Gilberta
Gilruthia	Gilruthia
Gnaphalium	Gnaphalium
Gnephosis	Gnephosis
Gochnatia	Gochnatia
Gongylolepis	Gongylolepis
Gorteria	Gorteria
Greenmaniella	Greenmaniella
Grindelia	Grindelia
Guardiola	Guardiola
Guizotia	Guizotia
Gundelia	Gundelia
Gundlachia	Gundlachia
Gutierrezia	Gutierrezia
Guynesomia	Guynesomia
Gymnanthemum	Gymnanthemum
Gymnarrhena	Gymnarrhena
Gymnodiscus	Gymnodiscus
Gymnolaena	Gymnolaena
Gymnosperma	Gymnosperma
Haegiela	Haegiela
Haplocarpha	Haplocarpha
Haploesthes	Haploesthes
Haplopappus	Haplopappus
Haptotrichion	Haptotrichion
Hazardia	Hazardia
Hedypnois	Hedypnois
Helenium	Helenium
Helianthella	Helianthella
Helianthus	Helianthus
Helichrysum	Helichrysum
Helipterum	Helipterum
Helminthotheca	Helminthotheca
Hemisteptia	Hemisteptia
Herrickia	Herrickia
Hesperevax	Hesperevax
Hesperomannia	Hesperomannia
Heterolepis	Heterolepis
Heterosperma	Heterosperma
Heterotheca	Heterotheca
Hieracium	Hieracium
Himalaiella	Himalaiella
Hirpicium	Hirpicium
Hirtellina	Hirtellina
Hispidella	Hispidella
Hofmeisteria	Hofmeisteria
Holocarpha	Holocarpha
Homogyne	Homogyne
Hoplophyllum	Hoplophyllum
Hulsea	Hulsea
Hyalea	Hyalea
Hyalis	Hyalis
Hyalosperma	Hyalosperma
Hymenolepis	Hymenolepis
Hymenopappus	Hymenopappus
Hymenothrix	Hymenothrix
Hymenoxys	Hymenoxys
Hyoseris	Hyoseris
Hypochaeris	Hypochaeris
Hysterionica	Hysterionica
Ichthyothere	Ichthyothere
Idiopappus	Idiopappus
Ifloga	Ifloga
Inula	Inula
Iostephane	Iostephane
Iphiona	Iphiona
Iranecio	Iranecio
Isocoma	Isocoma
Isoetopsis	Isoetopsis
Iva	Iva
Ixeridium	Ixeridium
Ixeris	Ixeris
Jacobaea	Jacobaea
Jaegeria	Jaegeria
Jaumea	Jaumea
Jefea	Jefea
Jessea	Jessea
Jurinea	Jurinea
Kingianthus	Kingianthus
Klasea	Klasea
Kleinia	Kleinia
Koelpinia	Koelpinia
Krigia	Krigia
Lachanodes	Lachanodes
Lachnospermum	Lachnospermum
Lactuca	Lactuca
Lagascea	Lagascea
Lagenophora	Lagenophora
Laggera	Laggera
Lagophylla	Lagophylla
Lamyropappus	Lamyropappus
Lapsana	Lapsana
Lasianthaea	Lasianthaea
Lasiopogon	Lasiopogon
Lasiospermum	Lasiospermum
Lasthenia	Lasthenia
Launaea	Launaea
Lawrencella	Lawrencella
Layia	Layia
Lecocarpus	Lecocarpus
Leibnitzia	Leibnitzia
Leiocarpa	Leiocarpa
Lemooria	Lemooria
Leontodon	Leontodon
Leontopodium	Leontopodium
Lepidaploa	Lepidaploa
Lepidophyllum	Lepidophyllum
Leptinella	Leptinella
Leptorhynchos	Leptorhynchos
Lessingia	Lessingia
Leucanthemum	Leucanthemum
Leucheria	Leucheria
Leucochrysum	Leucochrysum
Leucogenes	Leucogenes
Leucophyta	Leucophyta
Leysera	Leysera
Liatris	Liatris
Lidbeckia	Lidbeckia
Ligularia	Ligularia
Ligulariopsis	Ligulariopsis
Limbarda	Limbarda
Lipochaeta	Lipochaeta
Logfia	Logfia
Lopholaena	Lopholaena
Lordhowea	Lordhowea
Loxothysanus	Loxothysanus
Lundellianthus	Lundellianthus
Machaeranthera	Machaeranthera
Macledium	Macledium
Madia	Madia
Mairia	Mairia
Malacothrix	Malacothrix
Marasmodes	Marasmodes
Marshallia	Marshallia
Matricaria	Matricaria
Megalodonta	Megalodonta
Melampodium	Melampodium
Melanodendron	Melanodendron
Melanthera	Melanthera
Mesogramma	Mesogramma
Metalasia	Metalasia
Micropus	Micropus
Microseris	Microseris
Mikania	Mikania
Milleria	Milleria
Millotia	Millotia
Minuria	Minuria
Monactis	Monactis
Monoculus	Monoculus
Monolopia	Monolopia
Monoptilon	Monoptilon
Montanoa	Montanoa
Mulgedium	Mulgedium
Munnozia	Munnozia
Mutisia	Mutisia
Mycelis	Mycelis
Myriocephalus	Myriocephalus
Myripnois	Myripnois
Myxopappus	Myxopappus
Nabalus	Nabalus
Nannoglottis	Nannoglottis
Nardophyllum	Nardophyllum
Nassauvia	Nassauvia
Nephrotheca	Nephrotheca
Nestotus	Nestotus
Neurolaena	Neurolaena
Nicolletia	Nicolletia
Nidorella	Nidorella
Nolletia	Nolletia
Nothocalais	Nothocalais
Noticastrum	Noticastrum
Notobasis	Notobasis
Oblivia	Oblivia
Odixia	Odixia
Oedera	Oedera
Oldenburgia	Oldenburgia
Olearia	Olearia
Olgaea	Olgaea
Oligochaeta	Oligochaeta
Oncosiphon	Oncosiphon
Onopordum	Onopordum
Onoseris	Onoseris
Oreochrysum	Oreochrysum
Oreoleysera	Oreoleysera
Osmitopsis	Osmitopsis
Osteospermum	Osteospermum
Otanthus	Otanthus
Oteiza	Oteiza
Othonna	Othonna
Otopappus	Otopappus
Oxypappus	Oxypappus
Oyedaea	Oyedaea
Ozothamnus	Ozothamnus
Pachystegia	Pachystegia
Packera	Packera
Palafoxia	Palafoxia
Pallenis	Pallenis
Parantennaria	Parantennaria
Parapolydora	Parapolydora
Parasenecio	Parasenecio
Parthenium	Parthenium
Pectis	Pectis
Pegolettia	Pegolettia
Pembertonia	Pembertonia
Pentanema	Pentanema
Pentzia	Pentzia
Perezia	Perezia
Pericallis	Pericallis
Pericome	Pericome
Perityle	Perityle
Perymeniopsis	Perymeniopsis
Perymenium	Perymenium
Petalacte	Petalacte
Petasites	Petasites
Petradoria	Petradoria
Peucephyllum	Peucephyllum
Phaenocoma	Phaenocoma
Phagnalon	Phagnalon
Phaneroglossa	Phaneroglossa
Philactis	Philactis
Philyrophyllum	Philyrophyllum
Phoebanthus	Phoebanthus
Phonus	Phonus
Phymaspermum	Phymaspermum
Picnomon	Picnomon
Picris	Picris
Pilosella	Pilosella
Pinaropappus	Pinaropappus
Piqueria	Piqueria
Pittocaulon	Pittocaulon
Pityopsis	Pityopsis
Plazia	Plazia
Plecostachys	Plecostachys
Plectocephalus	Plectocephalus
Pleiacanthus	Pleiacanthus
Pleuropappus	Pleuropappus
Pleurophyllum	Pleurophyllum
Pluchea	Pluchea
Podachaenium	Podachaenium
Podolepis	Podolepis
Podotheca	Podotheca
Pogonolepis	Pogonolepis
Polyarrhena	Polyarrhena
Polycalymma	Polycalymma
Polymnia	Polymnia
Porophyllum	Porophyllum
Prenanthes	Prenanthes
Printzia	Printzia
Proustia	Proustia
Psathyrotes	Psathyrotes
Psephellus	Psephellus
Pseudoclappia	Pseudoclappia
Pseudoconyza	Pseudoconyza
Pseudognaphalium	Pseudognaphalium
Psiadia	Psiadia
Psilocarphus	Psilocarphus
Psilostrophe	Psilostrophe
Pterochaeta	Pterochaeta
Pteronia	Pteronia
Pterygopappus	Pterygopappus
Ptilostemon	Ptilostemon
Pulicaria	Pulicaria
Pycnosorus	Pycnosorus
Pyrrhopappus	Pyrrhopappus
Pyrrocoma	Pyrrocoma
Quinqueremulus	Quinqueremulus
Rafinesquia	Rafinesquia
Raillardella	Raillardella
Raoulia	Raoulia
Ratibida	Ratibida
Rayjacksonia	Rayjacksonia
Reichardia	Reichardia
Relhania	Relhania
Remya	Remya
Rennera	Rennera
Rensonia	Rensonia
Rhagadiolus	Rhagadiolus
Rhanterium	Rhanterium
Rhaponticum	Rhaponticum
Rhodanthe	Rhodanthe
Rhodogeron	Rhodogeron
Rhynchospermum	Rhynchospermum
Riencourtia	Riencourtia
Rigiopappus	Rigiopappus
Robinsonia	Robinsonia
Rojasianthe	Rojasianthe
Roldana	Roldana
Rosenia	Rosenia
Rudbeckia	Rudbeckia
Rumfordia	Rumfordia
Rutidosis	Rutidosis
Sachsia	Sachsia
Santolina	Santolina
Sartwellia	Sartwellia
Saussurea	Saussurea
Scabrethia	Scabrethia
Scalesia	Scalesia
Schistostephium	Schistostephium
Schizogyne	Schizogyne
Schkuhria	Schkuhria
Schlechtendalia	Schlechtendalia
Schmalhausenia	Schmalhausenia
Schoenia	Schoenia
Scolymus	Scolymus
Scorzonera	Scorzonera
Scorzoneroides	Scorzoneroides
Senecio	Senecio
Serratula	Serratula
Sheareria	Sheareria
Siemssenia	Siemssenia
Sigesbeckia	Sigesbeckia
Siloxerus	Siloxerus
Silphium	Silphium
Silybum	Silybum
Simsia	Simsia
Sinacalia	Sinacalia
Sinosenecio	Sinosenecio
Smallanthus	Smallanthus
Solanecio	Solanecio
Solenogyne	Solenogyne
Solidago	Solidago
Soliva	Soliva
Sonchus	Sonchus
Sondottia	Sondottia
Sphaeromorphaea	Sphaeromorphaea
Sphagneticola	Sphagneticola
Spilanthes	Spilanthes
Squamopappus	Squamopappus
Staehelina	Staehelina
Stebbinsoseris	Stebbinsoseris
Steiractinia	Steiractinia
Stemmacantha	Stemmacantha
Stenachaenium	Stenachaenium
Stenoseris	Stenoseris
Stenotus	Stenotus
Stephanomeria	Stephanomeria
Stevia	Stevia
Stifftia	Stifftia
Stizolophus	Stizolophus
Stoebe	Stoebe
Stokesia	Stokesia
Streptoglossa	Streptoglossa
Stuartina	Stuartina
Symphyotrichum	Symphyotrichum
Syncarpha	Syncarpha
Synedrella	Synedrella
Syneilesis	Syneilesis
Synotis	Synotis
Syntrichopappus	Syntrichopappus
Synurus	Synurus
Taeckholmia	Taeckholmia
Tagetes	Tagetes
Tamaulipa	Tamaulipa
Tanacetum	Tanacetum
Taraxacum	Taraxacum
Tarchonanthus	Tarchonanthus
Telekia	Telekia
Tephroseris	Tephroseris
Tetrachyron	Tetrachyron
Tetradymia	Tetradymia
Tetragonotheca	Tetragonotheca
Tetramolopium	Tetramolopium
Thelesperma	Thelesperma
Thevenotia	Thevenotia
Thymophylla	Thymophylla
Tilesia	Tilesia
Tithonia	Tithonia
Tolpis	Tolpis
Townsendia	Townsendia
Tragopogon	Tragopogon
Traversia	Traversia
Trichanthodium	Trichanthodium
Trichocoryne	Trichocoryne
Trichogyne	Trichogyne
Tridax	Tridax
Trigonospermum	Trigonospermum
Trilisa	Trilisa
Tripleurospermum	Tripleurospermum
Tripteris	Tripteris
Triptilodiscus	Triptilodiscus
Trixis	Trixis
Tussilago	Tussilago
Tyrimnus	Tyrimnus
Uropappus	Uropappus
Urospermum	Urospermum
Ursinia	Ursinia
Varilla	Varilla
Vellereophyton	Vellereophyton
Venegasia	Venegasia
Verbesina	Verbesina
Vernonanthura	Vernonanthura
Vernonia	Vernonia
Vieraea	Vieraea
Viguiera	Viguiera
Villanova	Villanova
Vittadinia	Vittadinia
Waitzia	Waitzia
Wamalchitamia	Wamalchitamia
Warionia	Warionia
Wedelia	Wedelia
Werneria	Werneria
Wyethia	Wyethia
Xanthisma	Xanthisma
Xanthium	Xanthium
Xeranthemum	Xeranthemum
Xerochrysum	Xerochrysum
Xylorhiza	Xylorhiza
Xylothamia	Xylothamia
Youngia	Youngia
Zaluzania	Zaluzania
Zexmenia	Zexmenia
Zinnia	Zinnia
Zoegea	Zoegea
Acicarpha	Acicarpha
Boopis	Boopis
Moschopsis	Moschopsis
Adenophora	Adenophora
Asyneuma	Asyneuma
Brighamia	Brighamia
Burmeistera	Burmeistera
Campanula	Campanula
Canarina	Canarina
Centropogon	Centropogon
Clermontia	Clermontia
Codonopsis	Codonopsis
Cyananthus	Cyananthus
Cyanea	Cyanea
Cyphia	Cyphia
Cyphocarpus	Cyphocarpus
Delissea	Delissea
Diastatea	Diastatea
Downingia	Downingia
Edraianthus	Edraianthus
Favratia	Favratia
Grammatotheca	Grammatotheca
Heterocodon	Heterocodon
Hippobroma	Hippobroma
Isotoma	Isotoma
Jasione	Jasione
Legousia	Legousia
Lobelia	Lobelia
Lysipomia	Lysipomia
Merciera	Merciera
Michauxia	Michauxia
Monopsis	Monopsis
Musschia	Musschia
Nemacladus	Nemacladus
Nesocodon	Nesocodon
Petromarula	Petromarula
Physoplexis	Physoplexis
Phyteuma	Phyteuma
Platycodon	Platycodon
Pratia	Pratia
Prismatocarpus	Prismatocarpus
Pseudonemacladus	Pseudonemacladus
Rhigiophyllum	Rhigiophyllum
Roella	Roella
Siphocampylus	Siphocampylus
Siphocodon	Siphocodon
Solenopsis	Solenopsis
Symphyandra	Symphyandra
Trachelium	Trachelium
Treichelia	Treichelia
Trematolobelia	Trematolobelia
Triodanis	Triodanis
Wahlenbergia	Wahlenbergia
Wimmerella	Wimmerella
Anthotium	Anthotium
Brunonia	Brunonia
Coopernookia	Coopernookia
Crossotoma	Crossotoma
Dampiera	Dampiera
Diaspasis	Diaspasis
Goodenia	Goodenia
Lechenaultia	Lechenaultia
Scaevola	Scaevola
Selliera	Selliera
Velleia	Velleia
Verreauxia	Verreauxia
Liparophyllum	Liparophyllum
Menyanthes	Menyanthes
Nymphoides	Nymphoides
Villarsia	Villarsia
Pentaphragma	Pentaphragma
Phelline	Phelline
Abrophyllum	Abrophyllum
Carpodetus	Carpodetus
Cuttsia	Cuttsia
Roussea	Roussea
Donatia	Donatia
Forstera	Forstera
Levenhookia	Levenhookia
Oreostylidium	Oreostylidium
Phyllachne	Phyllachne
Stylidium	Stylidium
Austrobaileya	Austrobaileya
Illicium	Illicium
Kadsura	Kadsura
Schisandra	Schisandra
Trimenia	Trimenia
Aextoxicon	Aextoxicon
Berberidopsis	Berberidopsis
Alkanna	Alkanna
Amsinckia	Amsinckia
Anchusa	Anchusa
Antiphytum	Antiphytum
Arnebia	Arnebia
Borago	Borago
Bothriospermum	Bothriospermum
Bourreria	Bourreria
Brunnera	Brunnera
Buglossoides	Buglossoides
Cerinthe	Cerinthe
Codon	Codon
Coldenia	Coldenia
Cordia	Cordia
Cryptantha	Cryptantha
Cynoglossum	Cynoglossum
Cystostemon	Cystostemon
Draperia	Draperia
Echiochilon	Echiochilon
Echiostachys	Echiostachys
Echium	Echium
Ehretia	Ehretia
Ellisia	Ellisia
Emmenanthe	Emmenanthe
Eriodictyon	Eriodictyon
Eritrichium	Eritrichium
Eucrypta	Eucrypta
Euploca	Euploca
Glandora	Glandora
Hackelia	Hackelia
Heliotropium	Heliotropium
Hesperochiron	Hesperochiron
Hydrophyllum	Hydrophyllum
Lappula	Lappula
Lindelofia	Lindelofia
Lithospermum	Lithospermum
Lobostemon	Lobostemon
Mertensia	Mertensia
Moltkia	Moltkia
Moltkiopsis	Moltkiopsis
Myosotidium	Myosotidium
Myosotis	Myosotis
Nama	Nama
Neatostema	Neatostema
Nemophila	Nemophila
Nonea	Nonea
Ogastemma	Ogastemma
Omphalodes	Omphalodes
Onosma	Onosma
Onosmodium	Onosmodium
Pardoglossum	Pardoglossum
Pentaglottis	Pentaglottis
Phacelia	Phacelia
Pholisma	Pholisma
Plagiobothrys	Plagiobothrys
Pontechium	Pontechium
Pulmonaria	Pulmonaria
Rochelia	Rochelia
Romanzoffia	Romanzoffia
Solenanthus	Solenanthus
Symphytum	Symphytum
Tiquilia	Tiquilia
Tournefortia	Tournefortia
Trachystemon	Trachystemon
Trichodesma	Trichodesma
Trigonotis	Trigonotis
Turricula	Turricula
Viticella	Viticella
Wigandia	Wigandia
Akania	Akania
Bretschneidera	Bretschneidera
Batis	Batis
Aethionema	Aethionema
Alliaria	Alliaria
Alyssoides	Alyssoides
Alyssum	Alyssum
Anastatica	Anastatica
Anchonium	Anchonium
Anelsonia	Anelsonia
Arabidella	Arabidella
Arabidopsis	Arabidopsis
Arabis	Arabis
Armoracia	Armoracia
Athysanus	Athysanus
Aubrieta	Aubrieta
Aurinia	Aurinia
Baimashania	Baimashania
Ballantinia	Ballantinia
Barbarea	Barbarea
Berteroa	Berteroa
Biscutella	Biscutella
Blennodia	Blennodia
Boechera	Boechera
Boreava	Boreava
Brassica	Brassica
Braya	Braya
Bunias	Bunias
Cakile	Cakile
Calepina	Calepina
Camelina	Camelina
Capsella	Capsella
Cardamine	Cardamine
Carrichtera	Carrichtera
Catolobus	Catolobus
Caulanthus	Caulanthus
Chalcanthus	Chalcanthus
Chamira	Chamira
Chorispora	Chorispora
Christolea	Christolea
Clypeola	Clypeola
Cochlearia	Cochlearia
Coincya	Coincya
Coluteocarpus	Coluteocarpus
Conringia	Conringia
Crambe	Crambe
Cremolobus	Cremolobus
Crucihimalaya	Crucihimalaya
Cusickiella	Cusickiella
Descurainia	Descurainia
Dilophia	Dilophia
Dimorphocarpa	Dimorphocarpa
Diplotaxis	Diplotaxis
Diptychocarpus	Diptychocarpus
Dithyrea	Dithyrea
Dontostemon	Dontostemon
Draba	Draba
Enarthrocarpus	Enarthrocarpus
Eremobium	Eremobium
Eruca	Eruca
Erucaria	Erucaria
Erucastrum	Erucastrum
Erysimum	Erysimum
Euclidium	Euclidium
Eutrema	Eutrema
Exhalimolobos	Exhalimolobos
Farsetia	Farsetia
Fibigia	Fibigia
Goldbachia	Goldbachia
Guillenia	Guillenia
Halimolobos	Halimolobos
Heliophila	Heliophila
Hesperidanthus	Hesperidanthus
Hesperis	Hesperis
Hirschfeldia	Hirschfeldia
Hormathophylla	Hormathophylla
Hornungia	Hornungia
Hymenolobus	Hymenolobus
Ianhedgea	Ianhedgea
Iberis	Iberis
Idahoa	Idahoa
Iodanthus	Iodanthus
Isatis	Isatis
Iskandera	Iskandera
Leavenworthia	Leavenworthia
Leiospora	Leiospora
Lepidium	Lepidium
Leptaleum	Leptaleum
Lobularia	Lobularia
Malcolmia	Malcolmia
Mathewsia	Mathewsia
Matthiola	Matthiola
Megacarpaea	Megacarpaea
Morettia	Morettia
Moricandia	Moricandia
Moriera	Moriera
Mostacillastrum	Mostacillastrum
Myagrum	Myagrum
Nasturtiopsis	Nasturtiopsis
Nasturtium	Nasturtium
Neotorularia	Neotorularia
Nerisyrenia	Nerisyrenia
Neslia	Neslia
Neuontobotrys	Neuontobotrys
Nevada	Nevada
Noccaea	Noccaea
Notoceras	Notoceras
Ochthodium	Ochthodium
Olimarabidopsis	Olimarabidopsis
Oreoloma	Oreoloma
Orychophragmus	Orychophragmus
Pachycladon	Pachycladon
Parlatoria	Parlatoria
Parrya	Parrya
Paysonia	Paysonia
Pennellia	Pennellia
Petrocallis	Petrocallis
Phoenicaulis	Phoenicaulis
Physaria	Physaria
Planodes	Planodes
Polyctenium	Polyctenium
Pringlea	Pringlea
Pritzelago	Pritzelago
Pugionium	Pugionium
Raphanus	Raphanus
Rapistrum	Rapistrum
Ricotia	Ricotia
Rorippa	Rorippa
Schimpera	Schimpera
Schivereckia	Schivereckia
Schizopetalon	Schizopetalon
Schouwia	Schouwia
Selenia	Selenia
Sinapis	Sinapis
Sisymbriopsis	Sisymbriopsis
Sisymbrium	Sisymbrium
Smelowskia	Smelowskia
Stanleya	Stanleya
Stenopetalum	Stenopetalum
Sterigmostemum	Sterigmostemum
Streptanthella	Streptanthella
Streptanthus	Streptanthus
Subularia	Subularia
Tauscheria	Tauscheria
Teesdalia	Teesdalia
Tetracme	Tetracme
Thelypodium	Thelypodium
Thlaspi	Thlaspi
Thysanocarpus	Thysanocarpus
Tropidocarpum	Tropidocarpum
Turritis	Turritis
Zilla	Zilla
Apophyllum	Apophyllum
Boscia	Boscia
Cadaba	Cadaba
Capparis	Capparis
Cleoserrata	Cleoserrata
Crateva	Crateva
Forchhammeria	Forchhammeria
Maerua	Maerua
Morisonia	Morisonia
Ritchiea	Ritchiea
Carica	Carica
Cylicomorpha	Cylicomorpha
Jacaratia	Jacaratia
Jarilla	Jarilla
Vasconcellea	Vasconcellea
Cleome	Cleome
Cleomella	Cleomella
Dipterygium	Dipterygium
Oxystylis	Oxystylis
Peritoma	Peritoma
Podandrogyne	Podandrogyne
Polanisia	Polanisia
Wislizenia	Wislizenia
Codonocarpus	Codonocarpus
Gyrostemon	Gyrostemon
Tersonia	Tersonia
Koeberlinia	Koeberlinia
Floerkea	Floerkea
Limnanthes	Limnanthes
Moringa	Moringa
Pentadiplandra	Pentadiplandra
Caylusea	Caylusea
Ochradenus	Ochradenus
Oligomeris	Oligomeris
Reseda	Reseda
Salvadora	Salvadora
Setchellanthus	Setchellanthus
Tovaria	Tovaria
Tropaeolum	Tropaeolum
Trophaeastrum	Trophaeastrum
Audouinia	Audouinia
Berzelia	Berzelia
Brunia	Brunia
Linconia	Linconia
Lonchostoma	Lonchostoma
Mniothamnea	Mniothamnea
Nebelia	Nebelia
Pseudobaeckea	Pseudobaeckea
Raspalia	Raspalia
Staavia	Staavia
Thamnea	Thamnea
Tittmannia	Tittmannia
Columellia	Columellia
Desfontainia	Desfontainia
Buxus	Buxus
Didymeles	Didymeles
Pachysandra	Pachysandra
Sarcococca	Sarcococca
Styloceras	Styloceras
Canella	Canella
Cinnamodendron	Cinnamodendron
Cinnamosma	Cinnamosma
Pleodendron	Pleodendron
Warburgia	Warburgia
Drimys	Drimys
Pseudowintera	Pseudowintera
Takhtajania	Takhtajania
Tasmannia	Tasmannia
Zygogynum	Zygogynum
Achatocarpus	Achatocarpus
Phaulothamnus	Phaulothamnus
Acrosanthes	Acrosanthes
Aizoanthemum	Aizoanthemum
Aizoon	Aizoon
Amphibolia	Amphibolia
Apatesia	Apatesia
Aptenia	Aptenia
Aridaria	Aridaria
Braunsia	Braunsia
Brownanthus	Brownanthus
Carpanthea	Carpanthea
Carpobrotus	Carpobrotus
Caryotophora	Caryotophora
Cleretum	Cleretum
Conicosia	Conicosia
Conophytum	Conophytum
Delosperma	Delosperma
Dinteranthus	Dinteranthus
Disphyma	Disphyma
Dorotheanthus	Dorotheanthus
Drosanthemum	Drosanthemum
Enarganthe	Enarganthe
Erepsia	Erepsia
Eurystigma	Eurystigma
Fenestraria	Fenestraria
Galenia	Galenia
Gunniopsis	Gunniopsis
Hymenogyne	Hymenogyne
Jordaaniella	Jordaaniella
Juttadinteria	Juttadinteria
Lampranthus	Lampranthus
Lithops	Lithops
Mesembryanthemum	Mesembryanthemum
Meyerophytum	Meyerophytum
Monilaria	Monilaria
Namaquanthus	Namaquanthus
Namibia	Namibia
Orthopterum	Orthopterum
Oscularia	Oscularia
Phyllobolus	Phyllobolus
Prenia	Prenia
Psilocaulon	Psilocaulon
Ruschia	Ruschia
Saphesia	Saphesia
Sesuvium	Sesuvium
Skiatophytum	Skiatophytum
Synaptophyllum	Synaptophyllum
Tetragonia	Tetragonia
Titanopsis	Titanopsis
Trianthema	Trianthema
Tribulocarpus	Tribulocarpus
Trichodiadema	Trichodiadema
Wooleya	Wooleya
Zaleya	Zaleya
Achyranthes	Achyranthes
Achyropsis	Achyropsis
Acroglochin	Acroglochin
Aerva	Aerva
Agathophora	Agathophora
Agriophyllum	Agriophyllum
Allenrolfea	Allenrolfea
Alternanthera	Alternanthera
Amaranthus	Amaranthus
Anabasis	Anabasis
Anthochlamys	Anthochlamys
Aphanisma	Aphanisma
Arthraerua	Arthraerua
Arthrocnemum	Arthrocnemum
Atriplex	Atriplex
Axyris	Axyris
Bassia	Bassia
Beta	Beta
Bienertia	Bienertia
Blutaparon	Blutaparon
Borsczowia	Borsczowia
Borszczowia	Borszczowia
Bosea	Bosea
Calicorema	Calicorema
Camphorosma	Camphorosma
Celosia	Celosia
Centemopsis	Centemopsis
Centrostachys	Centrostachys
Ceratocarpus	Ceratocarpus
Chamissoa	Chamissoa
Charpentiera	Charpentiera
Chenopodium	Chenopodium
Climacoptera	Climacoptera
Corispermum	Corispermum
Cornulaca	Cornulaca
Cyathula	Cyathula
Cycloloma	Cycloloma
Deeringia	Deeringia
Dissocarpus	Dissocarpus
Dysphania	Dysphania
Einadia	Einadia
Enchylaena	Enchylaena
Eremophea	Eremophea
Eriochiton	Eriochiton
Exomis	Exomis
Froelichia	Froelichia
Gamanthus	Gamanthus
Girgensohnia	Girgensohnia
Gomphrena	Gomphrena
Grayia	Grayia
Guilleminea	Guilleminea
Hablitzia	Hablitzia
Halocnemum	Halocnemum
Halogeton	Halogeton
Halopeplis	Halopeplis
Halosarcia	Halosarcia
Halostachys	Halostachys
Haloxylon	Haloxylon
Hebanthe	Hebanthe
Hemichroa	Hemichroa
Hermbstaedtia	Hermbstaedtia
Heterostachys	Heterostachys
Holmbergia	Holmbergia
Horaninovia	Horaninovia
Iljinia	Iljinia
Iresine	Iresine
Kalidium	Kalidium
Krascheninnikovia	Krascheninnikovia
Kyphocarpa	Kyphocarpa
Leucosphaera	Leucosphaera
Maireana	Maireana
Malacocera	Malacocera
Manochlamys	Manochlamys
Marcelliopsis	Marcelliopsis
Microcnemum	Microcnemum
Microgynoecium	Microgynoecium
Monolepis	Monolepis
Neobassia	Neobassia
Nitrophila	Nitrophila
Noaea	Noaea
Nothosaerva	Nothosaerva
Nototrichium	Nototrichium
Ofaiston	Ofaiston
Oreobliton	Oreobliton
Osteocarpum	Osteocarpum
Pachycornia	Pachycornia
Panderia	Panderia
Pandiaka	Pandiaka
Patellifolia	Patellifolia
Petrosimonia	Petrosimonia
Pleuropetalum	Pleuropetalum
Polycnemum	Polycnemum
Pseudoplantago	Pseudoplantago
Psilotrichum	Psilotrichum
Ptilotus	Ptilotus
Pupalia	Pupalia
Rhagodia	Rhagodia
Rhaphidophyton	Rhaphidophyton
Salicornia	Salicornia
Salsola	Salsola
Sarcocornia	Sarcocornia
Scleroblitum	Scleroblitum
Sclerolaena	Sclerolaena
Sclerostegia	Sclerostegia
Sericocoma	Sericocoma
Sericostachys	Sericostachys
Spinacia	Spinacia
Suaeda	Suaeda
Sympegma	Sympegma
Tecticornia	Tecticornia
Threlkeldia	Threlkeldia
Tidestromia	Tidestromia
Traganum	Traganum
Anacampseros	Anacampseros
Avonia	Avonia
Grahamia	Grahamia
Ancistrocladus	Ancistrocladus
Asteropeia	Asteropeia
Barbeuia	Barbeuia
Anredera	Anredera
Basella	Basella
Acanthocereus	Acanthocereus
Ariocarpus	Ariocarpus
Armatocereus	Armatocereus
Astrophytum	Astrophytum
Austrocactus	Austrocactus
Austrocylindropuntia	Austrocylindropuntia
Aztekium	Aztekium
Blossfeldia	Blossfeldia
Brasiliopuntia	Brasiliopuntia
Browningia	Browningia
Calymmanthium	Calymmanthium
Carnegiea	Carnegiea
Castellanosia	Castellanosia
Cereus	Cereus
Copiapoa	Copiapoa
Corryocactus	Corryocactus
Coryphantha	Coryphantha
Cylindropuntia	Cylindropuntia
Disocactus	Disocactus
Echinocactus	Echinocactus
Echinocereus	Echinocereus
Echinopsis	Echinopsis
Epiphyllum	Epiphyllum
Epithelantha	Epithelantha
Eriosyce	Eriosyce
Escontria	Escontria
Eulychnia	Eulychnia
Ferocactus	Ferocactus
Frailea	Frailea
Gymnocalycium	Gymnocalycium
Harrisia	Harrisia
Hatiora	Hatiora
Hylocereus	Hylocereus
Isolatocereus	Isolatocereus
Lepismium	Lepismium
Leptocereus	Leptocereus
Maihuenia	Maihuenia
Maihueniopsis	Maihueniopsis
Mammillaria	Mammillaria
Myrtillocactus	Myrtillocactus
Neobuxbaumia	Neobuxbaumia
Neoraimondia	Neoraimondia
Neowerdermannia	Neowerdermannia
Obregonia	Obregonia
Opuntia	Opuntia
Pachycereus	Pachycereus
Parodia	Parodia
Pereskia	Pereskia
Pereskiopsis	Pereskiopsis
Pfeiffera	Pfeiffera
Quiabentia	Quiabentia
Rhipsalis	Rhipsalis
Schlumbergera	Schlumbergera
Selenicereus	Selenicereus
Stenocereus	Stenocereus
Stetsonia	Stetsonia
Turbinicarpus	Turbinicarpus
Achyronychia	Achyronychia
Agrostemma	Agrostemma
Alsinidendron	Alsinidendron
Arenaria	Arenaria
Atocion	Atocion
Cerastium	Cerastium
Colobanthus	Colobanthus
Dianthus	Dianthus
Drymaria	Drymaria
Eremogone	Eremogone
Gymnocarpos	Gymnocarpos
Gypsophila	Gypsophila
Herniaria	Herniaria
Holosteum	Holosteum
Honckenya	Honckenya
Illecebrum	Illecebrum
Lepyrodiclis	Lepyrodiclis
Lychnis	Lychnis
Minuartia	Minuartia
Moehringia	Moehringia
Moenchia	Moenchia
Myosoton	Myosoton
Oberna	Oberna
Paronychia	Paronychia
Petrorhagia	Petrorhagia
Polycarpon	Polycarpon
Pseudostellaria	Pseudostellaria
Pteranthus	Pteranthus
Sagina	Sagina
Saponaria	Saponaria
Schiedea	Schiedea
Scleranthus	Scleranthus
Silene	Silene
Spergula	Spergula
Spergularia	Spergularia
Stellaria	Stellaria
Telephium	Telephium
Vaccaria	Vaccaria
Velezia	Velezia
Viscaria	Viscaria
Alluaudia	Alluaudia
Calyptrotheca	Calyptrotheca
Ceraria	Ceraria
Decarya	Decarya
Didierea	Didierea
Dioncophyllum	Dioncophyllum
Habropetalum	Habropetalum
Triphyophyllum	Triphyophyllum
Aldrovanda	Aldrovanda
Dionaea	Dionaea
Drosera	Drosera
Drosophyllum	Drosophyllum
Frankenia	Frankenia
Gisekia	Gisekia
Halophytum	Halophytum
Limeum	Limeum
Adenogramma	Adenogramma
Corbichonia	Corbichonia
Glinus	Glinus
Hypertelis	Hypertelis
Mollugo	Mollugo
Pharnaceum	Pharnaceum
Calandrinia	Calandrinia
Calyptridium	Calyptridium
Cistanthe	Cistanthe
Claytonia	Claytonia
Erocallis	Erocallis
Hectorella	Hectorella
Lewisia	Lewisia
Lyallia	Lyallia
Montia	Montia
Montiopsis	Montiopsis
Phemeranthus	Phemeranthus
Philippiamra	Philippiamra
Nepenthes	Nepenthes
Abronia	Abronia
Acleisanthes	Acleisanthes
Allionia	Allionia
Andradea	Andradea
Anulocaulis	Anulocaulis
Belemia	Belemia
Boerhavia	Boerhavia
Bougainvillea	Bougainvillea
Commicarpus	Commicarpus
Cyphomeris	Cyphomeris
Guapira	Guapira
Mirabilis	Mirabilis
Neea	Neea
Okenia	Okenia
Phaeoptilum	Phaeoptilum
Pisonia	Pisonia
Pisoniella	Pisoniella
Ramisia	Ramisia
Reichenbachia	Reichenbachia
Tripterocalyx	Tripterocalyx
Physena	Physena
Agdestis	Agdestis
Ercilla	Ercilla
Gallesia	Gallesia
Ledenbergia	Ledenbergia
Lophiocarpus	Lophiocarpus
Microtea	Microtea
Petiveria	Petiveria
Phytolacca	Phytolacca
Rivina	Rivina
Aegialitis	Aegialitis
Afrolimon	Afrolimon
Armeria	Armeria
Ceratolimon	Ceratolimon
Ceratostigma	Ceratostigma
Dictyolimon	Dictyolimon
Dyerophytum	Dyerophytum
Goniolimon	Goniolimon
Limoniastrum	Limoniastrum
Limonium	Limonium
Plumbago	Plumbago
Psylliostachys	Psylliostachys
Saharanthus	Saharanthus
Aconogonon	Aconogonon
Antenoron	Antenoron
Antigonon	Antigonon
Atraphaxis	Atraphaxis
Bistorta	Bistorta
Brunnichia	Brunnichia
Calligonum	Calligonum
Chorizanthe	Chorizanthe
Coccoloba	Coccoloba
Dedeckera	Dedeckera
Emex	Emex
Eriogonum	Eriogonum
Fagopyrum	Fagopyrum
Fallopia	Fallopia
Gymnopodium	Gymnopodium
Johanneshowellia	Johanneshowellia
Knorringia	Knorringia
Koenigia	Koenigia
Muehlenbeckia	Muehlenbeckia
Neomillspaughia	Neomillspaughia
Oxyria	Oxyria
Persicaria	Persicaria
Podopterus	Podopterus
Polygonella	Polygonella
Polygonum	Polygonum
Pterostegia	Pterostegia
Rheum	Rheum
Rumex	Rumex
Ruprechtia	Ruprechtia
Symmeria	Symmeria
Triplaris	Triplaris
Portulaca	Portulaca
Portulacaria	Portulacaria
Rhabdodendron	Rhabdodendron
Sarcobatus	Sarcobatus
Simmondsia	Simmondsia
Stegnosperma	Stegnosperma
Talinella	Talinella
Talinum	Talinum
Myricaria	Myricaria
Reaumuria	Reaumuria
Tamarix	Tamarix
Allocassine	Allocassine
Anthodon	Anthodon
Apodostigma	Apodostigma
Brexia	Brexia
Canotia	Canotia
Cassine	Cassine
Catha	Catha
Celastrus	Celastrus
Cheiloclinium	Cheiloclinium
Cuervea	Cuervea
Denhamia	Denhamia
Dicarpellum	Dicarpellum
Elachyptera	Elachyptera
Elaeodendron	Elaeodendron
Empleuridium	Empleuridium
Euonymus	Euonymus
Gloveria	Gloveria
Gyminda	Gyminda
Gymnosporia	Gymnosporia
Hedraianthera	Hedraianthera
Hippocratea	Hippocratea
Hylenaea	Hylenaea
Lauridia	Lauridia
Lepuropetalon	Lepuropetalon
Loeseneriella	Loeseneriella
Macgregoria	Macgregoria
Maurocenia	Maurocenia
Maytenus	Maytenus
Menepetalum	Menepetalum
Mystroxylon	Mystroxylon
Parnassia	Parnassia
Paxistima	Paxistima
Peripterygia	Peripterygia
Peritassa	Peritassa
Plagiopteron	Plagiopteron
Pleurostylia	Pleurostylia
Pottingeria	Pottingeria
Prionostemma	Prionostemma
Pristimera	Pristimera
Psammomoya	Psammomoya
Pseudosalacia	Pseudosalacia
Pterocelastrus	Pterocelastrus
Putterlickia	Putterlickia
Reissantia	Reissantia
Robsonodendron	Robsonodendron
Salacia	Salacia
Salaciopsis	Salaciopsis
Schaefferia	Schaefferia
Semialarium	Semialarium
Simicratea	Simicratea
Siphonodon	Siphonodon
Stackhousia	Stackhousia
Tontelea	Tontelea
Tripterococcus	Tripterococcus
Tripterygium	Tripterygium
Lepidobotrys	Lepidobotrys
Ruptiliocarpon	Ruptiliocarpon
Ceratophyllum	Ceratophyllum
Ascarina	Ascarina
Chloranthus	Chloranthus
Hedyosmum	Hedyosmum
Sarcandra	Sarcandra
Amischotolype	Amischotolype
Aneilema	Aneilema
Anthericopsis	Anthericopsis
Belosynapsis	Belosynapsis
Buforrestia	Buforrestia
Callisia	Callisia
Cartonema	Cartonema
Cochliostema	Cochliostema
Coleotrype	Coleotrype
Commelina	Commelina
Dichorisandra	Dichorisandra
Elasis	Elasis
Floscopa	Floscopa
Geogenanthus	Geogenanthus
Gibasis	Gibasis
Murdannia	Murdannia
Palisota	Palisota
Pollia	Pollia
Polyspatha	Polyspatha
Rhopalephora	Rhopalephora
Siderasis	Siderasis
Spatholirion	Spatholirion
Stanfieldiella	Stanfieldiella
Tinantia	Tinantia
Tradescantia	Tradescantia
Tripogandra	Tripogandra
Weldenia	Weldenia
Anigozanthos	Anigozanthos
Conostylis	Conostylis
Dilatris	Dilatris
Haemodorum	Haemodorum
Lachnanthes	Lachnanthes
Macropidia	Macropidia
Tribonanthes	Tribonanthes
Wachendorfia	Wachendorfia
Xiphidium	Xiphidium
Hanguana	Hanguana
Helmholtzia	Helmholtzia
Philydrella	Philydrella
Philydrum	Philydrum
Eichhornia	Eichhornia
Heteranthera	Heteranthera
Hydrothrix	Hydrothrix
Monochoria	Monochoria
Pontederia	Pontederia
Alangium	Alangium
Cornus	Cornus
Swida	Swida
Curtisia	Curtisia
Grubbia	Grubbia
Broussaisia	Broussaisia
Cardiandra	Cardiandra
Carpenteria	Carpenteria
Decumaria	Decumaria
Deinanthe	Deinanthe
Deutzia	Deutzia
Dichroa	Dichroa
Fendlera	Fendlera
Fendlerella	Fendlerella
Hydrangea	Hydrangea
Jamesia	Jamesia
Kirengeshoma	Kirengeshoma
Philadelphus	Philadelphus
Platycrater	Platycrater
Schizophragma	Schizophragma
Whipplea	Whipplea
Hydrostachys	Hydrostachys
Aosa	Aosa
Blumenbachia	Blumenbachia
Caiophora	Caiophora
Cevallia	Cevallia
Chichicaste	Chichicaste
Eucnide	Eucnide
Fuertesia	Fuertesia
Gronovia	Gronovia
Huidobria	Huidobria
Klaprothia	Klaprothia
Loasa	Loasa
Mentzelia	Mentzelia
Nasa	Nasa
Nuttallia	Nuttallia
Petalonyx	Petalonyx
Plakothira	Plakothira
Presliophytum	Presliophytum
Schismocarpus	Schismocarpus
Scyphanthus	Scyphanthus
Xylopodia	Xylopodia
Camptotheca	Camptotheca
Davidia	Davidia
Diplopanax	Diplopanax
Mastixia	Mastixia
Nyssa	Nyssa
Aphloia	Aphloia
Crossosoma	Crossosoma
Glossopetalon	Glossopetalon
Velascoa	Velascoa
Geissoloma	Geissoloma
Guamatela	Guamatela
Stachyurus	Stachyurus
Euscaphis	Euscaphis
Staphylea	Staphylea
Turpinia	Turpinia
Ixerba	Ixerba
Strasburgeria	Strasburgeria
Anisophyllea	Anisophyllea
Combretocarpus	Combretocarpus
Poga	Poga
Polygonanthus	Polygonanthus
Begonia	Begonia
Hillebrandia	Hillebrandia
Coriaria	Coriaria
Corynocarpus	Corynocarpus
Abobra	Abobra
Acanthosicyos	Acanthosicyos
Actinostemma	Actinostemma
Alsomitra	Alsomitra
Ampelosicyos	Ampelosicyos
Ampelosycios	Ampelosycios
Anacaona	Anacaona
Apodanthera	Apodanthera
Austrobryonia	Austrobryonia
Baijiania	Baijiania
Bambekea	Bambekea
Benincasa	Benincasa
Bolbostemma	Bolbostemma
Brandegea	Brandegea
Bryonia	Bryonia
Calycophysum	Calycophysum
Cayaponia	Cayaponia
Cephalopentandra	Cephalopentandra
Ceratosanthes	Ceratosanthes
Chalema	Chalema
Cionosicyos	Cionosicyos
Citrullus	Citrullus
Coccinia	Coccinia
Cogniauxia	Cogniauxia
Corallocarpus	Corallocarpus
Ctenolepis	Ctenolepis
Cucumella	Cucumella
Cucumis	Cucumis
Cucurbita	Cucurbita
Cucurbitella	Cucurbitella
Cyclanthera	Cyclanthera
Dactyliandra	Dactyliandra
Dendrosicyos	Dendrosicyos
Dieterlea	Dieterlea
Diplocyclos	Diplocyclos
Doyerea	Doyerea
Ecballium	Ecballium
Echinocystis	Echinocystis
Echinopepon	Echinopepon
Elateriopsis	Elateriopsis
Eureiandra	Eureiandra
Fevillea	Fevillea
Gerrardanthus	Gerrardanthus
Gurania	Gurania
Guraniopsis	Guraniopsis
Gymnopetalum	Gymnopetalum
Gynostemma	Gynostemma
Halosicyos	Halosicyos
Hanburia	Hanburia
Helmontia	Helmontia
Hemsleya	Hemsleya
Herpetospermum	Herpetospermum
Ibervillea	Ibervillea
Indofevillea	Indofevillea
Kedrostis	Kedrostis
Lagenaria	Lagenaria
Lemurosicyos	Lemurosicyos
Linnaeosicyos	Linnaeosicyos
Luffa	Luffa
Marah	Marah
Melothria	Melothria
Melothrianthus	Melothrianthus
Momordica	Momordica
Muellerargia	Muellerargia
Neoalsomitra	Neoalsomitra
Odosicyos	Odosicyos
Oreosyce	Oreosyce
Parasicyos	Parasicyos
Penelopeia	Penelopeia
Peponium	Peponium
Peponopsis	Peponopsis
Polyclathra	Polyclathra
Posadaea	Posadaea
Praecitrullus	Praecitrullus
Psiguria	Psiguria
Pteropepon	Pteropepon
Raphidiocystis	Raphidiocystis
Ruthalicia	Ruthalicia
Schizocarpum	Schizocarpum
Schizopepon	Schizopepon
Scopellaria	Scopellaria
Sechiopsis	Sechiopsis
Sechium	Sechium
Selysia	Selysia
Seyrigia	Seyrigia
Sicana	Sicana
Sicydium	Sicydium
Sicyos	Sicyos
Sicyosperma	Sicyosperma
Siraitia	Siraitia
Solena	Solena
Tecunumania	Tecunumania
Telfairia	Telfairia
Thladiantha	Thladiantha
Trichosanthes	Trichosanthes
Tricyclandra	Tricyclandra
Trochomeria	Trochomeria
Trochomeriopsis	Trochomeriopsis
Tumamoca	Tumamoca
Wilbrandia	Wilbrandia
Xerosicyos	Xerosicyos
Zehneria	Zehneria
Zygosicyos	Zygosicyos
Datisca	Datisca
Tetrameles	Tetrameles
Actinostrobus	Actinostrobus
Athrotaxis	Athrotaxis
Austrocedrus	Austrocedrus
Callitris	Callitris
Calocedrus	Calocedrus
Chamaecyparis	Chamaecyparis
Cryptomeria	Cryptomeria
Cunninghamia	Cunninghamia
Cupressus	Cupressus
Diselma	Diselma
Fitzroya	Fitzroya
Fokienia	Fokienia
Glyptostrobus	Glyptostrobus
Juniperus	Juniperus
Libocedrus	Libocedrus
Metasequoia	Metasequoia
Microbiota	Microbiota
Papuacedrus	Papuacedrus
Pilgerodendron	Pilgerodendron
Platycladus	Platycladus
Sequoia	Sequoia
Sequoiadendron	Sequoiadendron
Taiwania	Taiwania
Taxodium	Taxodium
Tetraclinis	Tetraclinis
Thuja	Thuja
Thujopsis	Thujopsis
Widdringtonia	Widdringtonia
Xanthocyparis	Xanthocyparis
Sciadopitys	Sciadopitys
Amentotaxus	Amentotaxus
Austrotaxus	Austrotaxus
Cephalotaxus	Cephalotaxus
Pseudotaxus	Pseudotaxus
Taxus	Taxus
Torreya	Torreya
Cycas	Cycas
Bowenia	Bowenia
Ceratozamia	Ceratozamia
Dioon	Dioon
Encephalartos	Encephalartos
Lepidozamia	Lepidozamia
Macrozamia	Macrozamia
Microcycas	Microcycas
Stangeria	Stangeria
Zamia	Zamia
Curatella	Curatella
Davilla	Davilla
Dillenia	Dillenia
Doliocarpus	Doliocarpus
Hibbertia	Hibbertia
Pachynema	Pachynema
Pinzona	Pinzona
Tetracera	Tetracera
Burmannia	Burmannia
Gymnosiphon	Gymnosiphon
Dioscorea	Dioscorea
Rajania	Rajania
Stenomeris	Stenomeris
Tacca	Tacca
Trichopus	Trichopus
Aletris	Aletris
Lophiola	Lophiola
Narthecium	Narthecium
Adoxa	Adoxa
Sambucus	Sambucus
Sinadoxa	Sinadoxa
Tetradoxa	Tetradoxa
Viburnum	Viburnum
Abelia	Abelia
Acanthocalyx	Acanthocalyx
Astrephia	Astrephia
Centranthus	Centranthus
Cephalaria	Cephalaria
Cryptothladia	Cryptothladia
Diervilla	Diervilla
Dipelta	Dipelta
Dipsacus	Dipsacus
Fedia	Fedia
Heptacodium	Heptacodium
Knautia	Knautia
Kolkwitzia	Kolkwitzia
Leycesteria	Leycesteria
Linnaea	Linnaea
Lomelosia	Lomelosia
Lonicera	Lonicera
Morina	Morina
Nardostachys	Nardostachys
Patrinia	Patrinia
Plectritis	Plectritis
Pterocephalus	Pterocephalus
Pycnocomon	Pycnocomon
Scabiosa	Scabiosa
Sixalix	Sixalix
Succisa	Succisa
Succisella	Succisella
Symphoricarpos	Symphoricarpos
Triosteum	Triosteum
Triplostegia	Triplostegia
Valeriana	Valeriana
Valerianella	Valerianella
Weigela	Weigela
Xylosteon	Xylosteon
Zabelia	Zabelia
Ephedra	Ephedra
Actinidia	Actinidia
Clematoclethra	Clematoclethra
Saurauia	Saurauia
Impatiens	Impatiens
Clethra	Clethra
Purdiaea	Purdiaea
Cliftonia	Cliftonia
Cyrilla	Cyrilla
Berneuxia	Berneuxia
Diapensia	Diapensia
Galax	Galax
Pyxidanthera	Pyxidanthera
Sherwoodia	Sherwoodia
Shortia	Shortia
Diospyros	Diospyros
Euclea	Euclea
Lissocarpa	Lissocarpa
Acrothamnus	Acrothamnus
Acrotriche	Acrotriche
Agapetes	Agapetes
Agarista	Agarista
Andersonia	Andersonia
Andromeda	Andromeda
Androstoma	Androstoma
Anthopterus	Anthopterus
Arbutus	Arbutus
Archeria	Archeria
Arctostaphylos	Arctostaphylos
Arctous	Arctous
Astroloma	Astroloma
Bejaria	Bejaria
Brachyloma	Brachyloma
Bruckenthalia	Bruckenthalia
Bryanthus	Bryanthus
Budawangia	Budawangia
Calluna	Calluna
Cassiope	Cassiope
Cavendishia	Cavendishia
Ceratiola	Ceratiola
Ceratostema	Ceratostema
Chamaedaphne	Chamaedaphne
Chimaphila	Chimaphila
Comarostaphylis	Comarostaphylis
Conostephium	Conostephium
Corema	Corema
Cosmelia	Cosmelia
Craibiodendron	Craibiodendron
Croninia	Croninia
Cyathodes	Cyathodes
Daboecia	Daboecia
Dimorphanthera	Dimorphanthera
Diplarche	Diplarche
Diplycosia	Diplycosia
Disterigma	Disterigma
Dracophyllum	Dracophyllum
Elliottia	Elliottia
Empetrum	Empetrum
Enkianthus	Enkianthus
Epacris	Epacris
Epigaea	Epigaea
Erica	Erica
Eubotryoides	Eubotryoides
Eubotrys	Eubotrys
Gaultheria	Gaultheria
Gaylussacia	Gaylussacia
Harrimanella	Harrimanella
Herpothamnus	Herpothamnus
Hugeria	Hugeria
Hymenanthes	Hymenanthes
Kalmia	Kalmia
Lebetanthus	Lebetanthus
Ledothamnus	Ledothamnus
Leptecophylla	Leptecophylla
Leucopogon	Leucopogon
Leucothoe	Leucothoe
Lissanthe	Lissanthe
Lyonia	Lyonia
Lysinema	Lysinema
Macleania	Macleania
Melichrus	Melichrus
Menziesia	Menziesia
Moneses	Moneses
Monotoca	Monotoca
Monotropa	Monotropa
Monotropastrum	Monotropastrum
Monotropsis	Monotropsis
Needhamiella	Needhamiella
Oligarrhena	Oligarrhena
Ornithostaphylos	Ornithostaphylos
Orthilia	Orthilia
Oxydendrum	Oxydendrum
Paphia	Paphia
Pentachondra	Pentachondra
Phyllodoce	Phyllodoce
Pieris	Pieris
Planocarpa	Planocarpa
Plutarchia	Plutarchia
Polyclita	Polyclita
Prionotes	Prionotes
Psammisia	Psammisia
Pterospora	Pterospora
Pyrola	Pyrola
Rhododendron	Rhododendron
Rhodothamnus	Rhodothamnus
Richea	Richea
Rupicola	Rupicola
Sarcodes	Sarcodes
Satyria	Satyria
Semiramisia	Semiramisia
Siphonandra	Siphonandra
Sphenotoma	Sphenotoma
Sphyrospermum	Sphyrospermum
Sprengelia	Sprengelia
Styphelia	Styphelia
Tepuia	Tepuia
Themistoclesia	Themistoclesia
Thibaudia	Thibaudia
Trochocarpa	Trochocarpa
Vaccinium	Vaccinium
Woollsia	Woollsia
Xolisma	Xolisma
Xylococcus	Xylococcus
Zenobia	Zenobia
Fouquieria	Fouquieria
Allantoma	Allantoma
Asteranthos	Asteranthos
Barringtonia	Barringtonia
Bertholletia	Bertholletia
Careya	Careya
Cariniana	Cariniana
Chydenanthus	Chydenanthus
Corythophora	Corythophora
Couratari	Couratari
Couroupita	Couroupita
Eschweilera	Eschweilera
Foetidia	Foetidia
Grias	Grias
Gustavia	Gustavia
Lecythis	Lecythis
Napoleona	Napoleona
Oubanguia	Oubanguia
Petersianthus	Petersianthus
Planchonia	Planchonia
Rhaptopetalum	Rhaptopetalum
Scytopetalum	Scytopetalum
Marcgravia	Marcgravia
Marcgraviastrum	Marcgraviastrum
Norantea	Norantea
Ruyschia	Ruyschia
Sarcopera	Sarcopera
Schwartzia	Schwartzia
Souroubea	Souroubea
Mitrastemon	Mitrastemon
Adinandra	Adinandra
Anneslea	Anneslea
Cleyera	Cleyera
Eurya	Eurya
Euryodendron	Euryodendron
Pentaphylax	Pentaphylax
Ternstroemia	Ternstroemia
Acanthogilia	Acanthogilia
Aliciella	Aliciella
Allophyllum	Allophyllum
Bonplandia	Bonplandia
Bryantiella	Bryantiella
Cantua	Cantua
Cobaea	Cobaea
Collomia	Collomia
Eriastrum	Eriastrum
Gilia	Gilia
Giliastrum	Giliastrum
Gymnosteris	Gymnosteris
Ipomopsis	Ipomopsis
Langloisia	Langloisia
Leptosiphon	Leptosiphon
Linanthus	Linanthus
Loeselia	Loeselia
Loeseliastrum	Loeseliastrum
Microgilia	Microgilia
Microsteris	Microsteris
Navarretia	Navarretia
Phlox	Phlox
Polemonium	Polemonium
Saltugilia	Saltugilia
Aegiceras	Aegiceras
Anagallis	Anagallis
Androsace	Androsace
Ardisia	Ardisia
Ardisiandra	Ardisiandra
Asterolinon	Asterolinon
Bonellia	Bonellia
Bryocarpum	Bryocarpum
Clavija	Clavija
Coris	Coris
Cortusa	Cortusa
Cyclamen	Cyclamen
Deherainia	Deherainia
Dionysia	Dionysia
Dodecatheon	Dodecatheon
Elingamita	Elingamita
Hottonia	Hottonia
Jacquinia	Jacquinia
Lysimachia	Lysimachia
Maesa	Maesa
Myrsine	Myrsine
Omphalogramma	Omphalogramma
Parathesis	Parathesis
Pelletiera	Pelletiera
Pomatosace	Pomatosace
Primula	Primula
Rapanea	Rapanea
Samolus	Samolus
Soldanella	Soldanella
Sredinskya	Sredinskya
Theophrasta	Theophrasta
Trientalis	Trientalis
Vitaliana	Vitaliana
Roridula	Roridula
Argania	Argania
Aubregrinia	Aubregrinia
Beccariella	Beccariella
Breviea	Breviea
Burckella	Burckella
Chromolucuma	Chromolucuma
Chrysophyllum	Chrysophyllum
Delpydora	Delpydora
Diploon	Diploon
Ecclinusa	Ecclinusa
Elaeoluma	Elaeoluma
Englerophytum	Englerophytum
Lecomtedoxa	Lecomtedoxa
Leptostylis	Leptostylis
Madhuca	Madhuca
Manilkara	Manilkara
Micropholis	Micropholis
Niemeyera	Niemeyera
Omphalocarpum	Omphalocarpum
Palaquium	Palaquium
Pichonia	Pichonia
Planchonella	Planchonella
Pouteria	Pouteria
Pradosia	Pradosia
Pycnandra	Pycnandra
Sarcaulus	Sarcaulus
Sarcosperma	Sarcosperma
Sersalisia	Sersalisia
Sideroxylon	Sideroxylon
Synsepalum	Synsepalum
Xantolis	Xantolis
Darlingtonia	Darlingtonia
Heliamphora	Heliamphora
Sarracenia	Sarracenia
Ficalhoa	Ficalhoa
Sladenia	Sladenia
Alniphyllum	Alniphyllum
Bruinsmia	Bruinsmia
Halesia	Halesia
Huodendron	Huodendron
Melliodendron	Melliodendron
Pterostyrax	Pterostyrax
Rehderodendron	Rehderodendron
Sinojackia	Sinojackia
Styrax	Styrax
Symplocos	Symplocos
Pelliciera	Pelliciera
Pentamerista	Pentamerista
Apterosperma	Apterosperma
Camellia	Camellia
Franklinia	Franklinia
Glyptocarpa	Glyptocarpa
Gordonia	Gordonia
Laplacea	Laplacea
Polyspora	Polyspora
Pyrenaria	Pyrenaria
Schima	Schima
Stewartia	Stewartia
Tutcheria	Tutcheria
Anopterus	Anopterus
Eremosyne	Eremosyne
Escallonia	Escallonia
Forgesia	Forgesia
Polyosma	Polyosma
Tribeles	Tribeles
Valdivia	Valdivia
Abarema	Abarema
Abrus	Abrus
Acacia	Acacia
Acaciella	Acaciella
Acmispon	Acmispon
Acosmium	Acosmium
Acrocarpus	Acrocarpus
Adenanthera	Adenanthera
Adenocarpus	Adenocarpus
Adenodolichos	Adenodolichos
Adenolobus	Adenolobus
Adesmia	Adesmia
Aeschynomene	Aeschynomene
Afgekia	Afgekia
Afzelia	Afzelia
Aganope	Aganope
Alantsilodendron	Alantsilodendron
Albizia	Albizia
Aldina	Aldina
Alhagi	Alhagi
Amblygonocarpus	Amblygonocarpus
Amburana	Amburana
Amherstia	Amherstia
Amicia	Amicia
Ammodendron	Ammodendron
Ammopiptanthus	Ammopiptanthus
Amorpha	Amorpha
Amphicarpaea	Amphicarpaea
Amphithalea	Amphithalea
Anadenanthera	Anadenanthera
Anagyris	Anagyris
Anarthrophyllum	Anarthrophyllum
Andira	Andira
Angylocalyx	Angylocalyx
Anthonotha	Anthonotha
Anthyllis	Anthyllis
Antopetitia	Antopetitia
Aotus	Aotus
Aphanocalyx	Aphanocalyx
Apios	Apios
Apoplanesia	Apoplanesia
Apuleia	Apuleia
Apurimacia	Apurimacia
Arachis	Arachis
Arapatiella	Arapatiella
Archidendron	Archidendron
Archidendropsis	Archidendropsis
Arcoa	Arcoa
Argyrocytisus	Argyrocytisus
Argyrolobium	Argyrolobium
Aspalathus	Aspalathus
Astracantha	Astracantha
Astragalus	Astragalus
Ateleia	Ateleia
Augouardia	Augouardia
Austrosteenisia	Austrosteenisia
Baikiaea	Baikiaea
Balsamocarpon	Balsamocarpon
Baphia	Baphia
Baptisia	Baptisia
Barklya	Barklya
Batesia	Batesia
Baudouinia	Baudouinia
Bauhinia	Bauhinia
Berlinia	Berlinia
Biserrula	Biserrula
Bituminaria	Bituminaria
Bobgunnia	Bobgunnia
Bocoa	Bocoa
Bolusanthus	Bolusanthus
Bossiaea	Bossiaea
Bowdichia	Bowdichia
Brachypterum	Brachypterum
Brachystegia	Brachystegia
Brongniartia	Brongniartia
Brownea	Brownea
Brya	Brya
Bryaspis	Bryaspis
Burkea	Burkea
Bussea	Bussea
Butea	Butea
Cadia	Cadia
Caesalpinia	Caesalpinia
Cajanus	Cajanus
Calicotome	Calicotome
Callerya	Callerya
Calliandra	Calliandra
Calliandropsis	Calliandropsis
Calopogonium	Calopogonium
Calpocalyx	Calpocalyx
Calpurnia	Calpurnia
Campsiandra	Campsiandra
Camptosema	Camptosema
Campylotropis	Campylotropis
Canavalia	Canavalia
Candolleodendron	Candolleodendron
Caragana	Caragana
Carmichaelia	Carmichaelia
Cassia	Cassia
Castanospermum	Castanospermum
Cathormion	Cathormion
Cedrelinga	Cedrelinga
Cenostigma	Cenostigma
Centrolobium	Centrolobium
Centrosema	Centrosema
Ceratonia	Ceratonia
Cercidium	Cercidium
Cercis	Cercis
Chadsia	Chadsia
Chaetocalyx	Chaetocalyx
Chamaecrista	Chamaecrista
Chamaecytisus	Chamaecytisus
Chloroleucon	Chloroleucon
Chorizema	Chorizema
Cicer	Cicer
Cladrastis	Cladrastis
Clathrotropis	Clathrotropis
Cleobulia	Cleobulia
Clianthus	Clianthus
Clitoria	Clitoria
Coelidium	Coelidium
Cojoba	Cojoba
Colophospermum	Colophospermum
Colutea	Colutea
Colvillea	Colvillea
Conzattia	Conzattia
Copaifera	Copaifera
Cordyla	Cordyla
Coronilla	Coronilla
Coursetia	Coursetia
Craibia	Craibia
Cranocarpus	Cranocarpus
Cratylia	Cratylia
Crotalaria	Crotalaria
Crudia	Crudia
Cryptosepalum	Cryptosepalum
Cullen	Cullen
Cyamopsis	Cyamopsis
Cyathostegia	Cyathostegia
Cyclopia	Cyclopia
Cylicodiscus	Cylicodiscus
Cymbosema	Cymbosema
Cynometra	Cynometra
Cytisophyllum	Cytisophyllum
Cytisus	Cytisus
Dalbergia	Dalbergia
Dalbergiella	Dalbergiella
Dalea	Dalea
Daniellia	Daniellia
Daviesia	Daviesia
Deguelia	Deguelia
Delonix	Delonix
Derris	Derris
Desmanthus	Desmanthus
Desmodium	Desmodium
Detarium	Detarium
Dewevrea	Dewevrea
Dialium	Dialium
Dichilus	Dichilus
Dichrostachys	Dichrostachys
Dicorynia	Dicorynia
Dicraeopetalum	Dicraeopetalum
Dicymbe	Dicymbe
Didelotia	Didelotia
Dillwynia	Dillwynia
Dimorphandra	Dimorphandra
Dinizia	Dinizia
Dioclea	Dioclea
Diphysa	Diphysa
Diplotropis	Diplotropis
Dipogon	Dipogon
Dipteryx	Dipteryx
Diptychandra	Diptychandra
Distemonanthus	Distemonanthus
Dolichopsis	Dolichopsis
Dolichos	Dolichos
Dorycnium	Dorycnium
Dumasia	Dumasia
Dussia	Dussia
Ebenopsis	Ebenopsis
Ebenus	Ebenus
Elephantorrhiza	Elephantorrhiza
Eligmocarpus	Eligmocarpus
Elizabetha	Elizabetha
Endertia	Endertia
Endosamara	Endosamara
Englerodendron	Englerodendron
Entada	Entada
Enterolobium	Enterolobium
Eperua	Eperua
Erinacea	Erinacea
Eriosema	Eriosema
Erythrina	Erythrina
Erythrophleum	Erythrophleum
Erythrostemon	Erythrostemon
Euchresta	Euchresta
Eutaxia	Eutaxia
Eysenhardtia	Eysenhardtia
Faidherbia	Faidherbia
Fillaeopsis	Fillaeopsis
Fissicalyx	Fissicalyx
Flemingia	Flemingia
Fordia	Fordia
Gagnebina	Gagnebina
Galactia	Galactia
Galega	Galega
Gastrolobium	Gastrolobium
Genista	Genista
Genistidium	Genistidium
Geoffroea	Geoffroea
Gigasiphon	Gigasiphon
Gilbertiodendron	Gilbertiodendron
Gleditsia	Gleditsia
Gliricidia	Gliricidia
Glycine	Glycine
Glycyrrhiza	Glycyrrhiza
Gompholobium	Gompholobium
Goniorrhachis	Goniorrhachis
Gonocytisus	Gonocytisus
Goodia	Goodia
Gossweilerodendron	Gossweilerodendron
Gueldenstaedtia	Gueldenstaedtia
Guibourtia	Guibourtia
Gymnocladus	Gymnocladus
Haematoxylum	Haematoxylum
Halimodendron	Halimodendron
Hardenbergia	Hardenbergia
Hardwickia	Hardwickia
Havardia	Havardia
Hebestigma	Hebestigma
Hedysarum	Hedysarum
Hesperalbizia	Hesperalbizia
Hesperolaburnum	Hesperolaburnum
Hesperothamnus	Hesperothamnus
Heteroflorum	Heteroflorum
Hippocrepis	Hippocrepis
Hoffmannseggia	Hoffmannseggia
Hoita	Hoita
Holocalyx	Holocalyx
Hosackia	Hosackia
Hovea	Hovea
Hybosema	Hybosema
Hydrochorea	Hydrochorea
Hylodendron	Hylodendron
Hymenaea	Hymenaea
Hymenolobium	Hymenolobium
Hymenostegia	Hymenostegia
Hypocalyptus	Hypocalyptus
Indigastrum	Indigastrum
Indigofera	Indigofera
Inga	Inga
Inocarpus	Inocarpus
Intsia	Intsia
Isoberlinia	Isoberlinia
Isotropis	Isotropis
Jacksonia	Jacksonia
Jacqueshuberia	Jacqueshuberia
Julbernardia	Julbernardia
Kanaloa	Kanaloa
Kennedia	Kennedia
Kingiodendron	Kingiodendron
Koompassia	Koompassia
Kotschya	Kotschya
Kummerowia	Kummerowia
Labichea	Labichea
Lablab	Lablab
Laburnum	Laburnum
Lamprolobium	Lamprolobium
Lasiobema	Lasiobema
Lathyrus	Lathyrus
Lebeckia	Lebeckia
Lecointea	Lecointea
Lembotropis	Lembotropis
Lemuropisum	Lemuropisum
Lennea	Lennea
Lens	Lens
Leonardoxa	Leonardoxa
Leptoderris	Leptoderris
Lespedeza	Lespedeza
Lessertia	Lessertia
Leucaena	Leucaena
Libidibia	Libidibia
Librevillea	Librevillea
Liparia	Liparia
Loesenera	Loesenera
Lonchocarpus	Lonchocarpus
Lotononis	Lotononis
Lotus	Lotus
Luetzelburgia	Luetzelburgia
Lupinus	Lupinus
Lysidice	Lysidice
Lysiloma	Lysiloma
Lysiphyllum	Lysiphyllum
Maackia	Maackia
Machaerium	Machaerium
Macrolobium	Macrolobium
Macroptilium	Macroptilium
Macrotyloma	Macrotyloma
Maniltoa	Maniltoa
Marina	Marina
Mariosousa	Mariosousa
Martiodendron	Martiodendron
Medicago	Medicago
Melanoxylon	Melanoxylon
Melilotus	Melilotus
Melolobium	Melolobium
Microberlinia	Microberlinia
Microcharis	Microcharis
Microlobius	Microlobius
Mildbraediodendron	Mildbraediodendron
Millettia	Millettia
Mimosa	Mimosa
Mimozyganthus	Mimozyganthus
Mirbelia	Mirbelia
Mora	Mora
Mucuna	Mucuna
Mundulea	Mundulea
Myrocarpus	Myrocarpus
Myrospermum	Myrospermum
Myroxylon	Myroxylon
Neonotonia	Neonotonia
Neorautanenia	Neorautanenia
Neptunia	Neptunia
Newtonia	Newtonia
Nissolia	Nissolia
Oddoniodendron	Oddoniodendron
Olneya	Olneya
Onobrychis	Onobrychis
Ononis	Ononis
Ophrestia	Ophrestia
Ormocarpum	Ormocarpum
Ormosia	Ormosia
Ornithopus	Ornithopus
Otholobium	Otholobium
Ottleya	Ottleya
Oxylobium	Oxylobium
Oxyrhynchus	Oxyrhynchus
Oxystigma	Oxystigma
Oxytropis	Oxytropis
Pachyelasma	Pachyelasma
Pachyrhizus	Pachyrhizus
Paramacrolobium	Paramacrolobium
Parapiptadenia	Parapiptadenia
Pararchidendron	Pararchidendron
Paraserianthes	Paraserianthes
Parkia	Parkia
Parkinsonia	Parkinsonia
Parochetus	Parochetus
Pediomelum	Pediomelum
Peltogyne	Peltogyne
Peltophorum	Peltophorum
Pentaclethra	Pentaclethra
Pericopsis	Pericopsis
Petalostylis	Petalostylis
Peteria	Peteria
Petteria	Petteria
Phaseolus	Phaseolus
Philenoptera	Philenoptera
Phylacium	Phylacium
Phyllodium	Phyllodium
Phyllota	Phyllota
Phylloxylon	Phylloxylon
Pickeringia	Pickeringia
Pictetia	Pictetia
Piptadenia	Piptadenia
Piptadeniastrum	Piptadeniastrum
Piptadeniopsis	Piptadeniopsis
Piptanthus	Piptanthus
Piscidia	Piscidia
Pisum	Pisum
Pithecellobium	Pithecellobium
Plagiosiphon	Plagiosiphon
Plathymenia	Plathymenia
Platycyamus	Platycyamus
Platylobium	Platylobium
Platymiscium	Platymiscium
Platypodium	Platypodium
Podalyria	Podalyria
Podolobium	Podolobium
Poecilanthe	Poecilanthe
Poeppigia	Poeppigia
Poincianella	Poincianella
Poiretia	Poiretia
Poitea	Poitea
Polhillia	Polhillia
Pomaria	Pomaria
Pongamiopsis	Pongamiopsis
Priestleya	Priestleya
Prioria	Prioria
Prosopidastrum	Prosopidastrum
Prosopis	Prosopis
Pseudeminia	Pseudeminia
Pseudopiptadenia	Pseudopiptadenia
Pseudoprosopis	Pseudoprosopis
Pseudosindora	Pseudosindora
Pseudovigna	Pseudovigna
Psophocarpus	Psophocarpus
Psoralea	Psoralea
Psoralidium	Psoralidium
Psorothamnus	Psorothamnus
Pterocarpus	Pterocarpus
Pterodon	Pterodon
Pterogyne	Pterogyne
Pterolobium	Pterolobium
Pueraria	Pueraria
Pultenaea	Pultenaea
Racosperma	Racosperma
Rafnia	Rafnia
Ramorinoa	Ramorinoa
Recordoxylon	Recordoxylon
Retama	Retama
Rhodopis	Rhodopis
Rhynchosia	Rhynchosia
Robinia	Robinia
Rupertia	Rupertia
Salweenia	Salweenia
Samanea	Samanea
Saraca	Saraca
Schefflerodendron	Schefflerodendron
Schizolobium	Schizolobium
Schleinitzia	Schleinitzia
Schotia	Schotia
Scorodophloeus	Scorodophloeus
Scorpiurus	Scorpiurus
Securigera	Securigera
Senegalia	Senegalia
Senna	Senna
Sesbania	Sesbania
Shuteria	Shuteria
Sindora	Sindora
Sindoropsis	Sindoropsis
Smithia	Smithia
Sophora	Sophora
Spartium	Spartium
Spatholobus	Spatholobus
Sphaerolobium	Sphaerolobium
Sphinctospermum	Sphinctospermum
Stahlia	Stahlia
Stemonocoleus	Stemonocoleus
Stirtonanthus	Stirtonanthus
Stonesiella	Stonesiella
Storckiella	Storckiella
Strongylodon	Strongylodon
Strophostyles	Strophostyles
Stryphnodendron	Stryphnodendron
Stylosanthes	Stylosanthes
Sutherlandia	Sutherlandia
Swainsona	Swainsona
Swartzia	Swartzia
Sweetia	Sweetia
Syrmatium	Syrmatium
Tachigali	Tachigali
Tadehagi	Tadehagi
Tamarindus	Tamarindus
Taralea	Taralea
Taverniera	Taverniera
Teline	Teline
Templetonia	Templetonia
Tephrosia	Tephrosia
Teramnus	Teramnus
Tessmannia	Tessmannia
Tetraberlinia	Tetraberlinia
Tetrapleura	Tetrapleura
Tetrapterocarpon	Tetrapterocarpon
Thermopsis	Thermopsis
Tipuana	Tipuana
Trifolium	Trifolium
Trigonella	Trigonella
Tripodion	Tripodion
Tylosema	Tylosema
Ulex	Ulex
Umtiza	Umtiza
Uraria	Uraria
Uribea	Uribea
Urodon	Urodon
Vachellia	Vachellia
Vandasina	Vandasina
Vatairea	Vatairea
Vataireopsis	Vataireopsis
Vicia	Vicia
Vigna	Vigna
Viminaria	Viminaria
Virgilia	Virgilia
Vouacapoua	Vouacapoua
Wallaceodendron	Wallaceodendron
Wisteria	Wisteria
Xanthocercis	Xanthocercis
Xerocladia	Xerocladia
Xeroderris	Xeroderris
Xiphotheca	Xiphotheca
Xylia	Xylia
Zapoteca	Zapoteca
Zenia	Zenia
Zollernia	Zollernia
Zornia	Zornia
Zuccagnia	Zuccagnia
Zygia	Zygia
Acanthocladus	Acanthocladus
Badiera	Badiera
Bredemeyera	Bredemeyera
Carpolobia	Carpolobia
Comesperma	Comesperma
Monnina	Monnina
Moutabea	Moutabea
Nylandtia	Nylandtia
Polygala	Polygala
Salomonia	Salomonia
Securidaca	Securidaca
Triclisperma	Triclisperma
Xanthophyllum	Xanthophyllum
Quillaja	Quillaja
Cadellia	Cadellia
Guilfoylia	Guilfoylia
Recchia	Recchia
Stylobasium	Stylobasium
Suriana	Suriana
Alnus	Alnus
Betula	Betula
Carpinus	Carpinus
Corylus	Corylus
Ostrya	Ostrya
Ostryopsis	Ostryopsis
Allocasuarina	Allocasuarina
Casuarina	Casuarina
Ceuthostoma	Ceuthostoma
Gymnostoma	Gymnostoma
Castanea	Castanea
Castanopsis	Castanopsis
Chrysolepis	Chrysolepis
Fagus	Fagus
Lithocarpus	Lithocarpus
Quercus	Quercus
Trigonobalanus	Trigonobalanus
Alfaroa	Alfaroa
Carya	Carya
Cyclocarya	Cyclocarya
Engelhardia	Engelhardia
Juglans	Juglans
Oreomunnea	Oreomunnea
Platycarya	Platycarya
Pterocarya	Pterocarya
Rhoiptelea	Rhoiptelea
Canacomyrica	Canacomyrica
Comptonia	Comptonia
Morella	Morella
Myrica	Myrica
Nothofagus	Nothofagus
Ticodendron	Ticodendron
Eucommia	Eucommia
Aucuba	Aucuba
Garrya	Garrya
Acokanthera	Acokanthera
Adenium	Adenium
Aganosma	Aganosma
Alafia	Alafia
Allamanda	Allamanda
Allomarkgrafia	Allomarkgrafia
Alstonia	Alstonia
Alyxia	Alyxia
Amalocalyx	Amalocalyx
Ambelania	Ambelania
Ampelamus	Ampelamus
Amphineurion	Amphineurion
Amsonia	Amsonia
Ancylobothrys	Ancylobothrys
Anechites	Anechites
Angadenia	Angadenia
Anisotoma	Anisotoma
Anodendron	Anodendron
Apocynum	Apocynum
Araujia	Araujia
Asclepias	Asclepias
Aspidoglossum	Aspidoglossum
Aspidosperma	Aspidosperma
Astephanus	Astephanus
Baissea	Baissea
Beaumontia	Beaumontia
Blepharodon	Blepharodon
Brachystelma	Brachystelma
Calotropis	Calotropis
Cameraria	Cameraria
Caralluma	Caralluma
Carissa	Carissa
Carvalhoa	Carvalhoa
Cascabela	Cascabela
Catharanthus	Catharanthus
Cerbera	Cerbera
Cerberiopsis	Cerberiopsis
Ceropegia	Ceropegia
Chilocarpus	Chilocarpus
Chonemorpha	Chonemorpha
Cibirhiza	Cibirhiza
Cionura	Cionura
Cleghornia	Cleghornia
Condylocarpon	Condylocarpon
Couma	Couma
Craspidospermum	Craspidospermum
Cryptolepis	Cryptolepis
Cryptostegia	Cryptostegia
Cycladenia	Cycladenia
Cynanchum	Cynanchum
Dictyophleba	Dictyophleba
Diplolepis	Diplolepis
Diplorhynchus	Diplorhynchus
Dyera	Dyera
Echites	Echites
Ectadium	Ectadium
Edithcolea	Edithcolea
Elytropus	Elytropus
Epigynum	Epigynum
Eustegia	Eustegia
Farquharia	Farquharia
Fernaldia	Fernaldia
Finlaysonia	Finlaysonia
Fischeria	Fischeria
Fockea	Fockea
Forsteronia	Forsteronia
Funastrum	Funastrum
Funtumia	Funtumia
Galactophora	Galactophora
Geissospermum	Geissospermum
Gomphocarpus	Gomphocarpus
Gonioma	Gonioma
Gymnanthera	Gymnanthera
Hancornia	Hancornia
Haplophyton	Haplophyton
Himatanthus	Himatanthus
Holarrhena	Holarrhena
Hoodia	Hoodia
Hoya	Hoya
Ichnocarpus	Ichnocarpus
Isonema	Isonema
Kanahia	Kanahia
Kibatalia	Kibatalia
Kopsia	Kopsia
Lacmellea	Lacmellea
Laubertia	Laubertia
Lepinia	Lepinia
Lepiniopsis	Lepiniopsis
Leptadenia	Leptadenia
Macoubea	Macoubea
Macroscepis	Macroscepis
Malouetia	Malouetia
Mandevilla	Mandevilla
Margaretta	Margaretta
Marsdenia	Marsdenia
Mascarenhasia	Mascarenhasia
Matelea	Matelea
Melodinus	Melodinus
Mesechites	Mesechites
Metaplexis	Metaplexis
Micholitzia	Micholitzia
Microloma	Microloma
Microplumeria	Microplumeria
Molongum	Molongum
Mondia	Mondia
Motandra	Motandra
Neobracea	Neobracea
Nerium	Nerium
Ochrosia	Ochrosia
Odontadenia	Odontadenia
Omphalogonus	Omphalogonus
Oncinema	Oncinema
Oncinotis	Oncinotis
Orthanthera	Orthanthera
Oxypetalum	Oxypetalum
Oxystelma	Oxystelma
Pachypodium	Pachypodium
Papuechites	Papuechites
Parahancornia	Parahancornia
Parameria	Parameria
Parsonsia	Parsonsia
Peltastes	Peltastes
Pentalinon	Pentalinon
Pentarrhinum	Pentarrhinum
Pentatropis	Pentatropis
Pentopetia	Pentopetia
Pergularia	Pergularia
Periploca	Periploca
Pervillaea	Pervillaea
Petchia	Petchia
Petopentia	Petopentia
Picralima	Picralima
Pinochia	Pinochia
Plectaneia	Plectaneia
Pleiocarpa	Pleiocarpa
Pleioceras	Pleioceras
Pleurostelma	Pleurostelma
Plumeria	Plumeria
Pottsia	Pottsia
Prestonia	Prestonia
Pteralyxia	Pteralyxia
Quaqua	Quaqua
Raphionacme	Raphionacme
Rauvolfia	Rauvolfia
Rhabdadenia	Rhabdadenia
Rhazya	Rhazya
Rhigospira	Rhigospira
Rhyssolobium	Rhyssolobium
Riocreuxia	Riocreuxia
Saba	Saba
Sarcostemma	Sarcostemma
Schizostephanus	Schizostephanus
Schizozygia	Schizozygia
Secamone	Secamone
Secondatia	Secondatia
Sindechites	Sindechites
Skytanthus	Skytanthus
Spirolobium	Spirolobium
Stapelia	Stapelia
Stathmostelma	Stathmostelma
Stemmadenia	Stemmadenia
Stephanostema	Stephanostema
Stephanotis	Stephanotis
Stipecoma	Stipecoma
Stomatostemma	Stomatostemma
Strophanthus	Strophanthus
Tabernaemontana	Tabernaemontana
Tabernanthe	Tabernanthe
Tacazzea	Tacazzea
Temnadenia	Temnadenia
Thevetia	Thevetia
Thyrsanthella	Thyrsanthella
Tintinnabularia	Tintinnabularia
Tonduzia	Tonduzia
Toxocarpus	Toxocarpus
Trachelospermum	Trachelospermum
Tylophora	Tylophora
Urceola	Urceola
Vahadenia	Vahadenia
Vallaris	Vallaris
Vallesia	Vallesia
Vinca	Vinca
Vincetoxicum	Vincetoxicum
Voacanga	Voacanga
Wrightia	Wrightia
Xysmalobium	Xysmalobium
Zygostelma	Zygostelma
Gelsemium	Gelsemium
Mostuea	Mostuea
Anthocleista	Anthocleista
Bartonia	Bartonia
Blackstonia	Blackstonia
Canscora	Canscora
Centaurium	Centaurium
Chionogentias	Chionogentias
Chironia	Chironia
Cicendia	Cicendia
Comastoma	Comastoma
Eustoma	Eustoma
Exacum	Exacum
Fagraea	Fagraea
Frasera	Frasera
Gentiana	Gentiana
Gentianella	Gentianella
Gentianopsis	Gentianopsis
Halenia	Halenia
Lapithea	Lapithea
Lomatogonium	Lomatogonium
Macrocarpaea	Macrocarpaea
Neurotheca	Neurotheca
Obolaria	Obolaria
Orphium	Orphium
Potalia	Potalia
Sabatia	Sabatia
Saccifolium	Saccifolium
Schenkia	Schenkia
Sebaea	Sebaea
Swertia	Swertia
Tachiadenus	Tachiadenus
Voyria	Voyria
Voyriella	Voyriella
Zeltnera	Zeltnera
Antonia	Antonia
Bonyunia	Bonyunia
Gardneria	Gardneria
Geniostoma	Geniostoma
Logania	Logania
Mitrasacme	Mitrasacme
Mitreola	Mitreola
Neuburgia	Neuburgia
Norrisia	Norrisia
Spigelia	Spigelia
Strychnos	Strychnos
Usteria	Usteria
Acranthera	Acranthera
Adina	Adina
Adinauclea	Adinauclea
Afrocanthium	Afrocanthium
Agathisanthemum	Agathisanthemum
Aidia	Aidia
Alberta	Alberta
Alibertia	Alibertia
Allenanthus	Allenanthus
Alseis	Alseis
Amaioua	Amaioua
Amphiasma	Amphiasma
Amphidasya	Amphidasya
Anthospermum	Anthospermum
Antirhea	Antirhea
Aoranthe	Aoranthe
Arachnothryx	Arachnothryx
Arcytophyllum	Arcytophyllum
Argostemma	Argostemma
Asperula	Asperula
Atractocarpus	Atractocarpus
Aulacocalyx	Aulacocalyx
Bathysa	Bathysa
Batopedina	Batopedina
Bertiera	Bertiera
Bikkia	Bikkia
Bobea	Bobea
Borojoa	Borojoa
Bothriospora	Bothriospora
Bouvardia	Bouvardia
Bremeria	Bremeria
Breonadia	Breonadia
Breonia	Breonia
Bullockia	Bullockia
Burchellia	Burchellia
Burttdavya	Burttdavya
Callipeltis	Callipeltis
Calochone	Calochone
Calycophyllum	Calycophyllum
Canthium	Canthium
Capirona	Capirona
Carapichea	Carapichea
Carphalea	Carphalea
Casasia	Casasia
Catesbaea	Catesbaea
Catunaregam	Catunaregam
Cephalanthus	Cephalanthus
Chamaepentas	Chamaepentas
Chassalia	Chassalia
Chazaliella	Chazaliella
Chimarrhis	Chimarrhis
Chiococca	Chiococca
Chomelia	Chomelia
Ciliosemina	Ciliosemina
Cinchona	Cinchona
Cinchonopsis	Cinchonopsis
Coccocypselum	Coccocypselum
Coddia	Coddia
Coelospermum	Coelospermum
Coffea	Coffea
Condaminea	Condaminea
Conostomium	Conostomium
Coprosma	Coprosma
Coptosapelta	Coptosapelta
Coptosperma	Coptosperma
Corynanthe	Corynanthe
Cosmibuena	Cosmibuena
Coussarea	Coussarea
Coutaportla	Coutaportla
Coutarea	Coutarea
Craterispermum	Craterispermum
Cremaspora	Cremaspora
Crossopteryx	Crossopteryx
Crucianella	Crucianella
Cruciata	Cruciata
Cruckshanksia	Cruckshanksia
Cubanola	Cubanola
Damnacanthus	Damnacanthus
Danais	Danais
Declieuxia	Declieuxia
Deppea	Deppea
Dialypetalanthus	Dialypetalanthus
Dictyandra	Dictyandra
Didymaea	Didymaea
Didymosalpinx	Didymosalpinx
Diodella	Diodella
Diodia	Diodia
Diplospora	Diplospora
Dirichletia	Dirichletia
Discospermum	Discospermum
Dolicholobium	Dolicholobium
Dolichopentas	Dolichopentas
Duperrea	Duperrea
Duroia	Duroia
Elaeagia	Elaeagia
Emmenopterys	Emmenopterys
Empogona	Empogona
Erithalis	Erithalis
Ernodea	Ernodea
Euclinia	Euclinia
Exostema	Exostema
Fadogia	Fadogia
Fadogiella	Fadogiella
Faramea	Faramea
Feretia	Feretia
Fernelia	Fernelia
Fleroya	Fleroya
Gaertnera	Gaertnera
Galium	Galium
Galopina	Galopina
Gardenia	Gardenia
Genipa	Genipa
Geophila	Geophila
Glossostipula	Glossostipula
Gonzalagunia	Gonzalagunia
Guettarda	Guettarda
Gynochthodes	Gynochthodes
Gyrostipula	Gyrostipula
Haldina	Haldina
Hamelia	Hamelia
Hedyotis	Hedyotis
Heinsenia	Heinsenia
Heinsia	Heinsia
Hekistocarpa	Hekistocarpa
Hillia	Hillia
Hintonia	Hintonia
Hodgkinsonia	Hodgkinsonia
Houstonia	Houstonia
Hydnophytum	Hydnophytum
Hymenodictyon	Hymenodictyon
Hyperacanthus	Hyperacanthus
Hypobathrum	Hypobathrum
Isertia	Isertia
Ixora	Ixora
Jackiopsis	Jackiopsis
Janotia	Janotia
Joosia	Joosia
Kadua	Kadua
Keetia	Keetia
Kelloggia	Kelloggia
Kerianthera	Kerianthera
Knoxia	Knoxia
Kohautia	Kohautia
Kraussia	Kraussia
Kutchubaea	Kutchubaea
Ladenbergia	Ladenbergia
Larsenaikia	Larsenaikia
Lasianthus	Lasianthus
Lelya	Lelya
Leptactina	Leptactina
Leptodermis	Leptodermis
Lerchea	Lerchea
Luculia	Luculia
Ludekia	Ludekia
Macbrideina	Macbrideina
Machaonia	Machaonia
Macrocnemum	Macrocnemum
Manettia	Manettia
Maschalocorymbus	Maschalocorymbus
Massularia	Massularia
Metadina	Metadina
Mitchella	Mitchella
Mitracarpus	Mitracarpus
Mitragyna	Mitragyna
Mitriostigma	Mitriostigma
Morinda	Morinda
Multidentia	Multidentia
Mussaenda	Mussaenda
Mussaendopsis	Mussaendopsis
Mycetia	Mycetia
Myonima	Myonima
Myrmecodia	Myrmecodia
Myrmeconauclea	Myrmeconauclea
Nauclea	Nauclea
Nematostylis	Nematostylis
Nenax	Nenax
Neohymenopogon	Neohymenopogon
Neolamarckia	Neolamarckia
Neonauclea	Neonauclea
Nertera	Nertera
Neurocalyx	Neurocalyx
Notopleura	Notopleura
Ochreinauclea	Ochreinauclea
Oldenlandia	Oldenlandia
Opercularia	Opercularia
Ophiorrhiza	Ophiorrhiza
Oreopolus	Oreopolus
Otiophora	Otiophora
Otomeria	Otomeria
Oxyanthus	Oxyanthus
Paederia	Paederia
Pagamea	Pagamea
Palicourea	Palicourea
Paracoffea	Paracoffea
Paracorynanthe	Paracorynanthe
Paragenipa	Paragenipa
Parapentas	Parapentas
Paratriaina	Paratriaina
Pauridiantha	Pauridiantha
Pausinystalia	Pausinystalia
Pavetta	Pavetta
Pentagonia	Pentagonia
Pentanisia	Pentanisia
Pentanopsis	Pentanopsis
Pentas	Pentas
Pentodon	Pentodon
Pertusadina	Pertusadina
Phuopsis	Phuopsis
Phyllis	Phyllis
Phyllopentas	Phyllopentas
Phylohydrax	Phylohydrax
Pinckneya	Pinckneya
Plectroniella	Plectroniella
Plocama	Plocama
Pogonolobus	Pogonolobus
Pogonopus	Pogonopus
Polysphaeria	Polysphaeria
Pomax	Pomax
Posoqueria	Posoqueria
Pouchetia	Pouchetia
Praravinia	Praravinia
Prismatomeris	Prismatomeris
Pseudomussaenda	Pseudomussaenda
Pseudosabicea	Pseudosabicea
Psilanthus	Psilanthus
Psychotria	Psychotria
Psydrax	Psydrax
Psyllocarpus	Psyllocarpus
Pygmaeothamnus	Pygmaeothamnus
Pyrostria	Pyrostria
Ramosmania	Ramosmania
Randia	Randia
Razafimandimbisonia	Razafimandimbisonia
Relbunium	Relbunium
Remijia	Remijia
Retiniphyllum	Retiniphyllum
Rhachicallis	Rhachicallis
Rhodopentas	Rhodopentas
Richardia	Richardia
Rondeletia	Rondeletia
Rosenbergiodendron	Rosenbergiodendron
Rothmannia	Rothmannia
Rovaeanthus	Rovaeanthus
Rubia	Rubia
Rudgea	Rudgea
Rustia	Rustia
Rutidea	Rutidea
Rytigynia	Rytigynia
Sabicea	Sabicea
Saprosma	Saprosma
Sarcocephalus	Sarcocephalus
Schradera	Schradera
Schumanniophyton	Schumanniophyton
Scyphiphora	Scyphiphora
Sericanthe	Sericanthe
Serissa	Serissa
Sherardia	Sherardia
Simira	Simira
Sinoadina	Sinoadina
Sipanea	Sipanea
Sommera	Sommera
Spermacoce	Spermacoce
Spermadictyon	Spermadictyon
Stenaria	Stenaria
Stenostomum	Stenostomum
Stilpnophyllum	Stilpnophyllum
Strumpfia	Strumpfia
Synaptantha	Synaptantha
Tamridaea	Tamridaea
Tapiphyllum	Tapiphyllum
Tarenna	Tarenna
Tennantia	Tennantia
Theligonum	Theligonum
Timonius	Timonius
Tocoyena	Tocoyena
Triainolepis	Triainolepis
Tricalysia	Tricalysia
Uncaria	Uncaria
Urophyllum	Urophyllum
Valantia	Valantia
Vangueria	Vangueria
Virectaria	Virectaria
Warszewiczia	Warszewiczia
Wittmackanthus	Wittmackanthus
Xanthophytum	Xanthophytum
California	California
Erodium	Erodium
Geranium	Geranium
Hypseocharis	Hypseocharis
Monsonia	Monsonia
Pelargonium	Pelargonium
Sarcocaulon	Sarcocaulon
Wendtia	Wendtia
Bersama	Bersama
Francoa	Francoa
Greyia	Greyia
Melianthus	Melianthus
Viviania	Viviania
Ginkgo	Ginkgo
Gnetum	Gnetum
Gunnera	Gunnera
Myrothamnus	Myrothamnus
Dipentodon	Dipentodon
Perrottetia	Perrottetia
Gerrardina	Gerrardina
Huertea	Huertea
Tapiscia	Tapiscia
Apodytes	Apodytes
Cassinopsis	Cassinopsis
Chlamydocarya	Chlamydocarya
Dendrobangia	Dendrobangia
Icacina	Icacina
Iodes	Iodes
Poraqueiba	Poraqueiba
Pyrenacantha	Pyrenacantha
Sarcostigma	Sarcostigma
Oncotheca	Oncotheca
Porella	Porella
Acanthopsis	Acanthopsis
Acanthus	Acanthus
Andrographis	Andrographis
Aphelandra	Aphelandra
Asystasia	Asystasia
Avicennia	Avicennia
Barleria	Barleria
Blepharis	Blepharis
Brachystephanus	Brachystephanus
Bravaisia	Bravaisia
Carlowrightia	Carlowrightia
Crabbea	Crabbea
Crossandra	Crossandra
Duosperma	Duosperma
Dyschoriste	Dyschoriste
Elytraria	Elytraria
Eusiphon	Eusiphon
Hygrophila	Hygrophila
Hypoestes	Hypoestes
Isoglossa	Isoglossa
Justicia	Justicia
Lepidagathis	Lepidagathis
Mackaya	Mackaya
Megalochlamys	Megalochlamys
Mellera	Mellera
Mendoncia	Mendoncia
Monechma	Monechma
Nelsonia	Nelsonia
Neuracanthus	Neuracanthus
Pachystachys	Pachystachys
Phaulopsis	Phaulopsis
Razisea	Razisea
Ruellia	Ruellia
Ruttya	Ruttya
Sanchezia	Sanchezia
Sclerochiton	Sclerochiton
Strobilanthes	Strobilanthes
Thunbergia	Thunbergia
Trichanthera	Trichanthera
Whitfieldia	Whitfieldia
Adenocalymma	Adenocalymma
Amphilophium	Amphilophium
Amphitecna	Amphitecna
Bignonia	Bignonia
Campsidium	Campsidium
Campsis	Campsis
Catalpa	Catalpa
Catophractes	Catophractes
Chilopsis	Chilopsis
Crescentia	Crescentia
Cuspidaria	Cuspidaria
Cybistax	Cybistax
Deplanchea	Deplanchea
Dolichandrone	Dolichandrone
Eccremocarpus	Eccremocarpus
Fernandoa	Fernandoa
Fridericia	Fridericia
Godmania	Godmania
Handroanthus	Handroanthus
Incarvillea	Incarvillea
Jacaranda	Jacaranda
Kigelia	Kigelia
Lundia	Lundia
Macfadyena	Macfadyena
Manaosella	Manaosella
Mansoa	Mansoa
Markhamia	Markhamia
Martinella	Martinella
Millingtonia	Millingtonia
Newbouldia	Newbouldia
Ophiocolea	Ophiocolea
Oroxylum	Oroxylum
Pandorea	Pandorea
Perianthomega	Perianthomega
Phyllarthron	Phyllarthron
Pithecoctenium	Pithecoctenium
Pleonotoma	Pleonotoma
Podranea	Podranea
Radermachera	Radermachera
Rhigozum	Rhigozum
Rhodocolea	Rhodocolea
Sparattosperma	Sparattosperma
Spathodea	Spathodea
Stereospermum	Stereospermum
Stizophyllum	Stizophyllum
Tabebuia	Tabebuia
Tecoma	Tecoma
Tynanthus	Tynanthus
Xylophragma	Xylophragma
Zeyheria	Zeyheria
Byblis	Byblis
Calceolaria	Calceolaria
Jovellana	Jovellana
Porodittia	Porodittia
Carlemannia	Carlemannia
Silvianthus	Silvianthus
Achimenes	Achimenes
Aeschynanthus	Aeschynanthus
Agalmyla	Agalmyla
Amalophyllon	Amalophyllon
Anna	Anna
Asteranthera	Asteranthera
Besleria	Besleria
Boea	Boea
Briggsia	Briggsia
Chirita	Chirita
Cobananthus	Cobananthus
Codonanthe	Codonanthe
Columnea	Columnea
Cremersia	Cremersia
Cyrtandra	Cyrtandra
Diastema	Diastema
Didissandra	Didissandra
Drymonia	Drymonia
Episcia	Episcia
Fieldia	Fieldia
Gasteranthus	Gasteranthus
Gesneria	Gesneria
Glossoloma	Glossoloma
Gloxinia	Gloxinia
Goyazia	Goyazia
Haberlea	Haberlea
Hemiboea	Hemiboea
Henckelia	Henckelia
Heppiella	Heppiella
Hypocyrta	Hypocyrta
Kohleria	Kohleria
Lembocarpus	Lembocarpus
Lysionotus	Lysionotus
Mitraria	Mitraria
Monophyllaea	Monophyllaea
Monopyle	Monopyle
Moussonia	Moussonia
Napeanthus	Napeanthus
Negria	Negria
Nematanthus	Nematanthus
Neomortonia	Neomortonia
Niphaea	Niphaea
Oerstedina	Oerstedina
Opithandra	Opithandra
Ornithoboea	Ornithoboea
Paliavana	Paliavana
Paraboea	Paraboea
Paradrymonia	Paradrymonia
Pearcea	Pearcea
Phinaea	Phinaea
Primulina	Primulina
Ramonda	Ramonda
Reldia	Reldia
Rhabdothamnus	Rhabdothamnus
Rhoogeton	Rhoogeton
Rhynchoglossum	Rhynchoglossum
Rhytidophyllum	Rhytidophyllum
Saintpaulia	Saintpaulia
Sanango	Sanango
Sarmienta	Sarmienta
Seemannia	Seemannia
Sinningia	Sinningia
Smithiantha	Smithiantha
Streptocarpus	Streptocarpus
Titanotrichum	Titanotrichum
Tylopsacas	Tylopsacas
Vanhouttea	Vanhouttea
Achyrospermum	Achyrospermum
Acrotome	Acrotome
Aegiphila	Aegiphila
Aeollanthus	Aeollanthus
Agastache	Agastache
Ajuga	Ajuga
Amethystea	Amethystea
Anisochilus	Anisochilus
Anisomeles	Anisomeles
Ballota	Ballota
Basilicum	Basilicum
Betonica	Betonica
Blephilia	Blephilia
Callicarpa	Callicarpa
Caryopteris	Caryopteris
Cedronella	Cedronella
Chaiturus	Chaiturus
Chloanthes	Chloanthes
Cleonia	Cleonia
Clerodendrum	Clerodendrum
Clinopodium	Clinopodium
Colebrookea	Colebrookea
Collinsonia	Collinsonia
Congea	Congea
Conradina	Conradina
Cornutia	Cornutia
Cuminia	Cuminia
Cunila	Cunila
Cyanostegia	Cyanostegia
Cyclotrichium	Cyclotrichium
Dicrastylis	Dicrastylis
Dracocephalum	Dracocephalum
Elsholtzia	Elsholtzia
Endostemon	Endostemon
Eremostachys	Eremostachys
Faradaya	Faradaya
Galeopsis	Galeopsis
Glechoma	Glechoma
Gmelina	Gmelina
Gomphostemma	Gomphostemma
Haplostachys	Haplostachys
Hedeoma	Hedeoma
Hemiandra	Hemiandra
Hemigenia	Hemigenia
Holmskioldia	Holmskioldia
Horminum	Horminum
Hoslundia	Hoslundia
Hyptis	Hyptis
Hyssopus	Hyssopus
Isodon	Isodon
Kalaharia	Kalaharia
Lachnostachys	Lachnostachys
Lagochilus	Lagochilus
Lamium	Lamium
Lavandula	Lavandula
Leonotis	Leonotis
Leonurus	Leonurus
Lepechinia	Lepechinia
Leucas	Leucas
Lycopus	Lycopus
Marrubium	Marrubium
Melissa	Melissa
Melittis	Melittis
Mentha	Mentha
Micromeria	Micromeria
Moluccella	Moluccella
Monarda	Monarda
Monardella	Monardella
Mosla	Mosla
Nepeta	Nepeta
Newcastelia	Newcastelia
Ocimum	Ocimum
Oncinocalyx	Oncinocalyx
Origanum	Origanum
Otostegia	Otostegia
Oxera	Oxera
Paraphlomis	Paraphlomis
Perilla	Perilla
Peronema	Peronema
Perovskia	Perovskia
Petitia	Petitia
Phlomis	Phlomis
Phlomoides	Phlomoides
Phyllostegia	Phyllostegia
Physostegia	Physostegia
Pityrodia	Pityrodia
Platostoma	Platostoma
Plectranthus	Plectranthus
Pogogyne	Pogogyne
Pogostemon	Pogostemon
Poliomintha	Poliomintha
Prasium	Prasium
Premna	Premna
Prostanthera	Prostanthera
Prunella	Prunella
Pseudocaryopteris	Pseudocaryopteris
Pycnanthemum	Pycnanthemum
Pycnostachys	Pycnostachys
Rhododon	Rhododon
Rosmarinus	Rosmarinus
Rotheca	Rotheca
Rubiteucris	Rubiteucris
Rydingia	Rydingia
Salvia	Salvia
Satureja	Satureja
Schizonepeta	Schizonepeta
Schnabelia	Schnabelia
Scutellaria	Scutellaria
Sideritis	Sideritis
Solenostemon	Solenostemon
Stachys	Stachys
Stenogyne	Stenogyne
Synandra	Synandra
Syncolostemon	Syncolostemon
Tectona	Tectona
Teijsmanniodendron	Teijsmanniodendron
Teucridium	Teucridium
Teucrium	Teucrium
Thymbra	Thymbra
Thymus	Thymus
Trichostema	Trichostema
Tripora	Tripora
Vitex	Vitex
Westringia	Westringia
Ziziphora	Ziziphora
Pinguicula	Pinguicula
Utricularia	Utricularia
Craterostigma	Craterostigma
Lindernia	Lindernia
Torenia	Torenia
Craniolaria	Craniolaria
Ibicella	Ibicella
Martynia	Martynia
Proboscidea	Proboscidea
Lancea	Lancea
Mazus	Mazus
Abeliophyllum	Abeliophyllum
Chionanthus	Chionanthus
Comoranthus	Comoranthus
Fontanesia	Fontanesia
Forestiera	Forestiera
Forsythia	Forsythia
Fraxinus	Fraxinus
Haenianthus	Haenianthus
Jasminum	Jasminum
Ligustrum	Ligustrum
Menodora	Menodora
Myxopyrum	Myxopyrum
Nestegis	Nestegis
Noronhia	Noronhia
Notelaea	Notelaea
Nyctanthes	Nyctanthes
Olea	Olea
Osmanthus	Osmanthus
Phillyrea	Phillyrea
Picconia	Picconia
Priogymnanthus	Priogymnanthus
Schrebera	Schrebera
Syringa	Syringa
Agalinis	Agalinis
Alectra	Alectra
Asepalum	Asepalum
Aureolaria	Aureolaria
Bartsia	Bartsia
Bornmuellerantha	Bornmuellerantha
Boschniakia	Boschniakia
Brandisia	Brandisia
Buchnera	Buchnera
Castilleja	Castilleja
Cistanche	Cistanche
Conopholis	Conopholis
Cordylanthus	Cordylanthus
Cyclocheilon	Cyclocheilon
Cycnium	Cycnium
Dasistoma	Dasistoma
Epifagus	Epifagus
Euphrasia	Euphrasia
Graderia	Graderia
Harveya	Harveya
Hedbergia	Hedbergia
Hyobanche	Hyobanche
Lamourouxia	Lamourouxia
Lathraea	Lathraea
Lindenbergia	Lindenbergia
Melampyrum	Melampyrum
Melasma	Melasma
Micrargeria	Micrargeria
Myzorrhiza	Myzorrhiza
Odontites	Odontites
Orobanche	Orobanche
Orthocarpus	Orthocarpus
Parentucellia	Parentucellia
Pedicularis	Pedicularis
Phtheirospermum	Phtheirospermum
Rehmannia	Rehmannia
Rhinanthus	Rhinanthus
Rhynchocorys	Rhynchocorys
Schwalbea	Schwalbea
Seymeria	Seymeria
Sopubia	Sopubia
Striga	Striga
Thalesia	Thalesia
Tozzia	Tozzia
Triphysaria	Triphysaria
Paulownia	Paulownia
Ceratotheca	Ceratotheca
Harpagophytum	Harpagophytum
Sesamothamnus	Sesamothamnus
Sesamum	Sesamum
Uncarina	Uncarina
Glossostigma	Glossostigma
Leucocarpus	Leucocarpus
Mimulus	Mimulus
Peplidium	Peplidium
Phryma	Phryma
Anarrhinum	Anarrhinum
Angelonia	Angelonia
Antirrhinum	Antirrhinum
Bacopa	Bacopa
Besseya	Besseya
Callitriche	Callitriche
Campylanthus	Campylanthus
Chaenorhinum	Chaenorhinum
Chelone	Chelone
Chionophila	Chionophila
Collinsia	Collinsia
Cymbalaria	Cymbalaria
Derwentia	Derwentia
Digitalis	Digitalis
Erinus	Erinus
Galvezia	Galvezia
Gambelia	Gambelia
Globularia	Globularia
Gratiola	Gratiola
Hebe	Hebe
Heliohebe	Heliohebe
Hemiphragma	Hemiphragma
Hippuris	Hippuris
Holmgrenanthe	Holmgrenanthe
Hydrotriche	Hydrotriche
Isoplexis	Isoplexis
Keckiella	Keckiella
Kickxia	Kickxia
Lagotis	Lagotis
Limnophila	Limnophila
Linaria	Linaria
Littorella	Littorella
Lophospermum	Lophospermum
Maurandya	Maurandya
Mecardonia	Mecardonia
Melosperma	Melosperma
Micranthemum	Micranthemum
Misopates	Misopates
Mohavea	Mohavea
Monttea	Monttea
Neogaerrhinum	Neogaerrhinum
Neopicrorhiza	Neopicrorhiza
Nothochelone	Nothochelone
Nuttallanthus	Nuttallanthus
Ourisia	Ourisia
Penstemon	Penstemon
Plantago	Plantago
Poskea	Poskea
Russelia	Russelia
Schweinfurthia	Schweinfurthia
Scoparia	Scoparia
Stemodia	Stemodia
Tetranema	Tetranema
Tonella	Tonella
Veronica	Veronica
Veronicastrum	Veronicastrum
Plocosperma	Plocosperma
Schlegelia	Schlegelia
Synapsis	Synapsis
Agathelpis	Agathelpis
Alonsoa	Alonsoa
Antherothamnus	Antherothamnus
Aptosimum	Aptosimum
Barthlottia	Barthlottia
Bontia	Bontia
Buddleja	Buddleja
Capraria	Capraria
Celsia	Celsia
Chaenostoma	Chaenostoma
Chenopodiopsis	Chenopodiopsis
Colpias	Colpias
Cromidon	Cromidon
Dermatobotrys	Dermatobotrys
Diascia	Diascia
Diclis	Diclis
Dischisma	Dischisma
Emorya	Emorya
Eremophila	Eremophila
Freylinia	Freylinia
Glekia	Glekia
Gomphostigma	Gomphostigma
Hebenstretia	Hebenstretia
Hemimeris	Hemimeris
Jamesbrittenia	Jamesbrittenia
Leucophyllum	Leucophyllum
Limosella	Limosella
Lyperia	Lyperia
Manulea	Manulea
Manuleopsis	Manuleopsis
Melanospermum	Melanospermum
Microdon	Microdon
Myoporum	Myoporum
Nemesia	Nemesia
Oftia	Oftia
Peliostomum	Peliostomum
Phygelius	Phygelius
Polycarena	Polycarena
Pseudoselago	Pseudoselago
Reyemia	Reyemia
Sairocarpus	Sairocarpus
Scrophularia	Scrophularia
Selago	Selago
Sutera	Sutera
Teedia	Teedia
Tetraselago	Tetraselago
Trieenea	Trieenea
Verbascum	Verbascum
Walafrida	Walafrida
Zaluzianskya	Zaluzianskya
Bowkeria	Bowkeria
Euthystachys	Euthystachys
Halleria	Halleria
Ixianthes	Ixianthes
Nuxia	Nuxia
Retzia	Retzia
Stilbe	Stilbe
Polypremum	Polypremum
Tetrachondra	Tetrachondra
Thomandersia	Thomandersia
Acantholippia	Acantholippia
Aloysia	Aloysia
Bouchea	Bouchea
Chascanum	Chascanum
Citharexylum	Citharexylum
Coelocarpum	Coelocarpum
Duranta	Duranta
Glandularia	Glandularia
Junellia	Junellia
Lantana	Lantana
Lippia	Lippia
Neosparton	Neosparton
Petrea	Petrea
Phyla	Phyla
Priva	Priva
Rehdera	Rehdera
Rhaphithamnus	Rhaphithamnus
Stachytarpheta	Stachytarpheta
Verbena	Verbena
Atherosperma	Atherosperma
Daphnandra	Daphnandra
Doryphora	Doryphora
Dryadodaphne	Dryadodaphne
Laurelia	Laurelia
Laureliopsis	Laureliopsis
Nemuaron	Nemuaron
Calycanthus	Calycanthus
Chimonanthus	Chimonanthus
Idiospermum	Idiospermum
Gomortega	Gomortega
Gyrocarpus	Gyrocarpus
Hernandia	Hernandia
Illigera	Illigera
Sparattanthelium	Sparattanthelium
Actinodaphne	Actinodaphne
Adenodaphne	Adenodaphne
Aiouea	Aiouea
Alseodaphne	Alseodaphne
Anaueria	Anaueria
Aniba	Aniba
Apollonias	Apollonias
Aspidostemon	Aspidostemon
Beilschmiedia	Beilschmiedia
Caryodaphnopsis	Caryodaphnopsis
Cassytha	Cassytha
Chlorocardium	Chlorocardium
Cinnamomum	Cinnamomum
Cryptocarya	Cryptocarya
Dehaasia	Dehaasia
Dicypellium	Dicypellium
Dodecadenia	Dodecadenia
Endiandra	Endiandra
Endlicheria	Endlicheria
Eusideroxylon	Eusideroxylon
Hypodaphnis	Hypodaphnis
Iteadaphne	Iteadaphne
Laurus	Laurus
Licaria	Licaria
Lindera	Lindera
Litsea	Litsea
Machilus	Machilus
Mezilaurus	Mezilaurus
Nectandra	Nectandra
Neocinnamomum	Neocinnamomum
Neolitsea	Neolitsea
Nothaphoebe	Nothaphoebe
Ocotea	Ocotea
Parasassafras	Parasassafras
Persea	Persea
Phoebe	Phoebe
Pleurothyrium	Pleurothyrium
Potameia	Potameia
Potoxylon	Potoxylon
Povedadaphne	Povedadaphne
Rhodostemonodaphne	Rhodostemonodaphne
Sassafras	Sassafras
Sextonia	Sextonia
Sinosassafras	Sinosassafras
Tetranthera	Tetranthera
Umbellularia	Umbellularia
Urbanodendron	Urbanodendron
Williamodendron	Williamodendron
Austromatthaea	Austromatthaea
Ephippiandra	Ephippiandra
Hedycarya	Hedycarya
Hennecartia	Hennecartia
Hortonia	Hortonia
Kibara	Kibara
Kibaropsis	Kibaropsis
Levieria	Levieria
Macropeplus	Macropeplus
Matthaea	Matthaea
Mollinedia	Mollinedia
Monimia	Monimia
Palmeria	Palmeria
Peumus	Peumus
Steganthera	Steganthera
Tambourissa	Tambourissa
Wilkiea	Wilkiea
Xymalos	Xymalos
Glossocalyx	Glossocalyx
Siparuna	Siparuna
Alstroemeria	Alstroemeria
Bomarea	Bomarea
Drymophila	Drymophila
Leontochir	Leontochir
Luzuriaga	Luzuriaga
Campynema	Campynema
Campynemanthe	Campynemanthe
Androcymbium	Androcymbium
Baeometra	Baeometra
Burchardia	Burchardia
Colchicum	Colchicum
Disporum	Disporum
Hexacyrtis	Hexacyrtis
Iphigenia	Iphigenia
Ornithoglossum	Ornithoglossum
Prosartes	Prosartes
Schelhammera	Schelhammera
Tripladenia	Tripladenia
Uvularia	Uvularia
Wurmbea	Wurmbea
Arachnitis	Arachnitis
Amana	Amana
Calochortus	Calochortus
Cardiocrinum	Cardiocrinum
Clintonia	Clintonia
Erythronium	Erythronium
Fritillaria	Fritillaria
Gagea	Gagea
Lilium	Lilium
Lloydia	Lloydia
Medeola	Medeola
Nomocharis	Nomocharis
Notholirion	Notholirion
Streptopus	Streptopus
Tricyrtis	Tricyrtis
Tulipa	Tulipa
Amianthium	Amianthium
Anticlea	Anticlea
Chamaelirium	Chamaelirium
Chionographis	Chionographis
Helonias	Helonias
Heloniopsis	Heloniopsis
Melanthium	Melanthium
Paris	Paris
Schoenocaulon	Schoenocaulon
Stenanthium	Stenanthium
Toxicoscordion	Toxicoscordion
Trillium	Trillium
Veratrum	Veratrum
Xerophyllum	Xerophyllum
Ypsilandra	Ypsilandra
Zigadenus	Zigadenus
Petermannia	Petermannia
Lapageria	Lapageria
Philesia	Philesia
Rhipogonum	Rhipogonum
Smilax	Smilax
Alphonsea	Alphonsea
Ambavia	Ambavia
Anaxagorea	Anaxagorea
Ancana	Ancana
Annickia	Annickia
Annona	Annona
Artabotrys	Artabotrys
Asimina	Asimina
Asteranthe	Asteranthe
Bocageopsis	Bocageopsis
Cananga	Cananga
Cleistopholis	Cleistopholis
Craibella	Craibella
Cremastosperma	Cremastosperma
Cyathocalyx	Cyathocalyx
Cyathostemma	Cyathostemma
Cymbopetalum	Cymbopetalum
Dasymaschalon	Dasymaschalon
Deeringothamnus	Deeringothamnus
Desmopsis	Desmopsis
Diclinanona	Diclinanona
Disepalum	Disepalum
Drepananthus	Drepananthus
Duguetia	Duguetia
Enicosanthum	Enicosanthum
Ephedranthus	Ephedranthus
Fissistigma	Fissistigma
Fitzalania	Fitzalania
Fusaea	Fusaea
Goniothalamus	Goniothalamus
Greenwayodendron	Greenwayodendron
Guatteria	Guatteria
Haplostichanthus	Haplostichanthus
Hexalobus	Hexalobus
Hornschuchia	Hornschuchia
Isolona	Isolona
Klarobelia	Klarobelia
Letestudoxa	Letestudoxa
Lettowianthus	Lettowianthus
Malmea	Malmea
Marsypopetalum	Marsypopetalum
Meiocarpidium	Meiocarpidium
Meiogyne	Meiogyne
Melodorum	Melodorum
Mezzettia	Mezzettia
Mezzettiopsis	Mezzettiopsis
Miliusa	Miliusa
Mitrella	Mitrella
Mitrephora	Mitrephora
Mkilua	Mkilua
Monanthotaxis	Monanthotaxis
Monocarpia	Monocarpia
Monodora	Monodora
Mosannona	Mosannona
Neostenanthera	Neostenanthera
Onychopetalum	Onychopetalum
Orophea	Orophea
Oxandra	Oxandra
Petalolophus	Petalolophus
Phaeanthus	Phaeanthus
Piptostigma	Piptostigma
Platymitra	Platymitra
Polyalthia	Polyalthia
Polyceratocarpus	Polyceratocarpus
Popowia	Popowia
Porcelia	Porcelia
Pseudartabotrys	Pseudartabotrys
Pseudephedranthus	Pseudephedranthus
Pseudomalmea	Pseudomalmea
Pseudoxandra	Pseudoxandra
Pseuduvaria	Pseuduvaria
Richella	Richella
Rollinia	Rollinia
Ruizodendron	Ruizodendron
Sageraea	Sageraea
Sapranthus	Sapranthus
Stelechocarpus	Stelechocarpus
Stenanona	Stenanona
Tetrameranthus	Tetrameranthus
Toussaintia	Toussaintia
Trigynaea	Trigynaea
Trivalvaria	Trivalvaria
Unonopsis	Unonopsis
Uvaria	Uvaria
Uvariastrum	Uvariastrum
Xylopia	Xylopia
Degeneria	Degeneria
Eupomatia	Eupomatia
Galbulimima	Galbulimima
Dugandiodendron	Dugandiodendron
Elmerrillia	Elmerrillia
Liriodendron	Liriodendron
Magnolia	Magnolia
Manglietia	Manglietia
Michelia	Michelia
Talauma	Talauma
Brochoneura	Brochoneura
Cephalosphaera	Cephalosphaera
Coelocaryon	Coelocaryon
Compsoneura	Compsoneura
Gymnacranthera	Gymnacranthera
Haematodendron	Haematodendron
Horsfieldia	Horsfieldia
Iryanthera	Iryanthera
Knema	Knema
Mauloutchia	Mauloutchia
Myristica	Myristica
Otoba	Otoba
Pycnanthus	Pycnanthus
Staudtia	Staudtia
Virola	Virola
Acharia	Acharia
Camptostylus	Camptostylus
Carpotroche	Carpotroche
Ceratiosicyos	Ceratiosicyos
Chiangiodendron	Chiangiodendron
Dasylepis	Dasylepis
Erythrospermum	Erythrospermum
Guthriea	Guthriea
Gynocardia	Gynocardia
Hydnocarpus	Hydnocarpus
Kiggelaria	Kiggelaria
Lindackeria	Lindackeria
Pangium	Pangium
Ryparosa	Ryparosa
Trichadenia	Trichadenia
Balanops	Balanops
Bonnetia	Bonnetia
Ploiarium	Ploiarium
Calophyllum	Calophyllum
Caraipa	Caraipa
Clusiella	Clusiella
Endodesmia	Endodesmia
Haploclathra	Haploclathra
Kayea	Kayea
Kielmeyera	Kielmeyera
Mahurea	Mahurea
Mammea	Mammea
Marila	Marila
Mesua	Mesua
Poeciloneuron	Poeciloneuron
Anthodiscus	Anthodiscus
Caryocar	Caryocar
Acioa	Acioa
Afrolicania	Afrolicania
Atuna	Atuna
Chrysobalanus	Chrysobalanus
Couepia	Couepia
Grangeria	Grangeria
Hirtella	Hirtella
Licania	Licania
Magnistipula	Magnistipula
Maranthes	Maranthes
Neocarya	Neocarya
Allanblackia	Allanblackia
Chrysochlamys	Chrysochlamys
Clusia	Clusia
Dystovomita	Dystovomita
Garcinia	Garcinia
Hypericum	Hypericum
Montrouziera	Montrouziera
Moronobea	Moronobea
Myriandra	Myriandra
Pentadesma	Pentadesma
Platonia	Platonia
Symphonia	Symphonia
Tovomita	Tovomita
Tovomitopsis	Tovomitopsis
Bhesa	Bhesa
Centroplacus	Centroplacus
Ctenolophon	Ctenolophon
Dichapetalum	Dichapetalum
Tapura	Tapura
Bergia	Bergia
Elatine	Elatine
Erythroxylum	Erythroxylum
Nectaropetalum	Nectaropetalum
Acalypha	Acalypha
Acidocroton	Acidocroton
Acidoton	Acidoton
Actinostemon	Actinostemon
Adelia	Adelia
Adenochlaena	Adenochlaena
Adenocline	Adenocline
Adenopeltis	Adenopeltis
Adenophaedra	Adenophaedra
Adriana	Adriana
Afrotrewia	Afrotrewia
Agrostistachys	Agrostistachys
Alchornea	Alchornea
Alchorneopsis	Alchorneopsis
Aleurites	Aleurites
Amperea	Amperea
Amyrea	Amyrea
Anthostema	Anthostema
Aparisthmium	Aparisthmium
Apodiscus	Apodiscus
Argomuellera	Argomuellera
Astraea	Astraea
Astrococcus	Astrococcus
Aubletiana	Aubletiana
Baliospermum	Baliospermum
Baloghia	Baloghia
Bernardia	Bernardia
Bertya	Bertya
Beyeria	Beyeria
Blachia	Blachia
Blumeodendron	Blumeodendron
Bocquillonia	Bocquillonia
Bonania	Bonania
Brasiliocroton	Brasiliocroton
Calycopeplus	Calycopeplus
Caperonia	Caperonia
Caryodendron	Caryodendron
Cavacoa	Cavacoa
Cephalocroton	Cephalocroton
Cephalomappa	Cephalomappa
Chaetocarpus	Chaetocarpus
Cheilosa	Cheilosa
Chondrostylis	Chondrostylis
Chorisandrachne	Chorisandrachne
Chrozophora	Chrozophora
Claoxylon	Claoxylon
Cleidion	Cleidion
Clutia	Clutia
Cnesmone	Cnesmone
Cnidoscolus	Cnidoscolus
Cocconerion	Cocconerion
Codiaeum	Codiaeum
Colliguaja	Colliguaja
Colobocarpos	Colobocarpos
Conceveiba	Conceveiba
Croton	Croton
Crotonogynopsis	Crotonogynopsis
Crotonopsis	Crotonopsis
Cyrtogonone	Cyrtogonone
Cyttaranthus	Cyttaranthus
Dalechampia	Dalechampia
Dalembertia	Dalembertia
Dichostemma	Dichostemma
Dicoelia	Dicoelia
Discoclaoxylon	Discoclaoxylon
Discocleidion	Discocleidion
Discoglypremna	Discoglypremna
Ditrysinia	Ditrysinia
Ditta	Ditta
Dodecastigma	Dodecastigma
Droceloncia	Droceloncia
Dysopsis	Dysopsis
Elateriospermum	Elateriospermum
Endospermum	Endospermum
Enriquebeltrania	Enriquebeltrania
Erythrococca	Erythrococca
Euphorbia	Euphorbia
Excoecaria	Excoecaria
Fontainea	Fontainea
Garcia	Garcia
Givotia	Givotia
Glycydendron	Glycydendron
Grimmeodendron	Grimmeodendron
Grossera	Grossera
Gymnanthes	Gymnanthes
Hancea	Hancea
Hevea	Hevea
Hippomane	Hippomane
Homalanthus	Homalanthus
Homonoia	Homonoia
Hura	Hura
Hylandia	Hylandia
Jatropha	Jatropha
Joannesia	Joannesia
Klaineanthus	Klaineanthus
Koilodepas	Koilodepas
Lasiocroton	Lasiocroton
Leidesia	Leidesia
Leucocroton	Leucocroton
Lobanilia	Lobanilia
Macaranga	Macaranga
Mallotus	Mallotus
Manihot	Manihot
Manniophyton	Manniophyton
Maprounea	Maprounea
Mareya	Mareya
Mareyopsis	Mareyopsis
Martretia	Martretia
Melanolepis	Melanolepis
Mercurialis	Mercurialis
Micrandra	Micrandra
Micrandropsis	Micrandropsis
Micrococca	Micrococca
Microstachys	Microstachys
Moacroton	Moacroton
Monotaxis	Monotaxis
Moultonianthus	Moultonianthus
Nealchornea	Nealchornea
Necepsia	Necepsia
Neoboutonia	Neoboutonia
Neoguillauminia	Neoguillauminia
Neoholstia	Neoholstia
Neoscortechinia	Neoscortechinia
Neoshirakia	Neoshirakia
Omphalea	Omphalea
Ophellantha	Ophellantha
Ostodes	Ostodes
Pachystroma	Pachystroma
Paracroton	Paracroton
Paranecepsia	Paranecepsia
Pausandra	Pausandra
Pera	Pera
Philyra	Philyra
Pimelodendron	Pimelodendron
Plagiostyles	Plagiostyles
Plukenetia	Plukenetia
Pogonophora	Pogonophora
Pseudagrostistachys	Pseudagrostistachys
Pseudosenefeldera	Pseudosenefeldera
Pycnocoma	Pycnocoma
Ricinocarpos	Ricinocarpos
Ricinodendron	Ricinodendron
Ricinus	Ricinus
Rockinghamia	Rockinghamia
Sagotia	Sagotia
Sandwithia	Sandwithia
Sapium	Sapium
Schinziophyton	Schinziophyton
Sclerocroton	Sclerocroton
Sebastiania	Sebastiania
Seidelia	Seidelia
Spathiostemon	Spathiostemon
Speranskia	Speranskia
Spirostachys	Spirostachys
Stillingia	Stillingia
Strophioblachia	Strophioblachia
Sumbaviopsis	Sumbaviopsis
Suregada	Suregada
Syndyophyllum	Syndyophyllum
Tannodia	Tannodia
Tetrorchidium	Tetrorchidium
Thyrsanthera	Thyrsanthera
Tragia	Tragia
Tragiella	Tragiella
Triadica	Triadica
Trigonopleura	Trigonopleura
Trigonostemon	Trigonostemon
Vernicia	Vernicia
Wetria	Wetria
Euphronia	Euphronia
Goupia	Goupia
Humiria	Humiria
Sacoglottis	Sacoglottis
Vantanea	Vantanea
Cratoxylum	Cratoxylum
Harungana	Harungana
Psorospermum	Psorospermum
Thornea	Thornea
Triadenum	Triadenum
Vismia	Vismia
Desbordesia	Desbordesia
Irvingia	Irvingia
Klainedoxa	Klainedoxa
Cyrillopsis	Cyrillopsis
Ixonanthes	Ixonanthes
Ochthocosmus	Ochthocosmus
Lacistema	Lacistema
Lozania	Lozania
Adenolinum	Adenolinum
Hesperolinon	Hesperolinon
Hugonia	Hugonia
Linum	Linum
Radiola	Radiola
Reinwardtia	Reinwardtia
Roucheria	Roucheria
Sclerolinon	Sclerolinon
Tirpitzia	Tirpitzia
Lophopyxis	Lophopyxis
Acmanthera	Acmanthera
Acridocarpus	Acridocarpus
Aenigmatanthera	Aenigmatanthera
Amorimia	Amorimia
Aspicarpa	Aspicarpa
Aspidopterys	Aspidopterys
Banisteriopsis	Banisteriopsis
Barnebya	Barnebya
Blepharandra	Blepharandra
Bunchosia	Bunchosia
Burdachia	Burdachia
Byrsonima	Byrsonima
Callaeum	Callaeum
Caucanthus	Caucanthus
Coleostachys	Coleostachys
Cordobia	Cordobia
Diacidia	Diacidia
Dicella	Dicella
Dinemagonum	Dinemagonum
Dinemandra	Dinemandra
Diplopterys	Diplopterys
Echinopterys	Echinopterys
Ectopopterys	Ectopopterys
Flabellaria	Flabellaria
Flabellariopsis	Flabellariopsis
Gallardoa	Gallardoa
Galphimia	Galphimia
Gaudichaudia	Gaudichaudia
Glandonia	Glandonia
Heladena	Heladena
Hemsleyna	Hemsleyna
Heteropterys	Heteropterys
Hiptage	Hiptage
Hiraea	Hiraea
Janusia	Janusia
Jubelina	Jubelina
Lophanthera	Lophanthera
Lophopterys	Lophopterys
Malpighia	Malpighia
Mascagnia	Mascagnia
Mcvaughia	Mcvaughia
Mezia	Mezia
Mionandra	Mionandra
Niedenzuella	Niedenzuella
Peixotoa	Peixotoa
Pterandra	Pterandra
Ptilochaeta	Ptilochaeta
Rhynchophora	Rhynchophora
Ryssopterys	Ryssopterys
Spachea	Spachea
Sphedamnocarpus	Sphedamnocarpus
Stigmaphyllon	Stigmaphyllon
Tetrapterys	Tetrapterys
Thryallis	Thryallis
Triaspis	Triaspis
Tricomaria	Tricomaria
Triopterys	Triopterys
Tristellateia	Tristellateia
Verrucularina	Verrucularina
Cespedesia	Cespedesia
Diporidium	Diporidium
Elvasia	Elvasia
Froesia	Froesia
Gomphia	Gomphia
Lacunaria	Lacunaria
Lophira	Lophira
Luxemburgia	Luxemburgia
Medusagyne	Medusagyne
Ochna	Ochna
Ouratea	Ouratea
Quiina	Quiina
Sauvagesia	Sauvagesia
Touroulia	Touroulia
Galearia	Galearia
Microdesmis	Microdesmis
Panda	Panda
Adenia	Adenia
Disemma	Disemma
Malesherbia	Malesherbia
Paropsia	Paropsia
Passiflora	Passiflora
Piriqueta	Piriqueta
Tetrapathaea	Tetrapathaea
Tetrastylis	Tetrastylis
Turnera	Turnera
Actephila	Actephila
Amanoa	Amanoa
Andrachne	Andrachne
Antidesma	Antidesma
Aporusa	Aporusa
Astrocasia	Astrocasia
Baccaurea	Baccaurea
Bischofia	Bischofia
Breynia	Breynia
Bridelia	Bridelia
Chascotheca	Chascotheca
Cleistanthus	Cleistanthus
Didymocistus	Didymocistus
Discocarpus	Discocarpus
Flueggea	Flueggea
Glochidion	Glochidion
Gonatogyne	Gonatogyne
Heterosavia	Heterosavia
Heywoodia	Heywoodia
Hieronyma	Hieronyma
Hymenocardia	Hymenocardia
Jablonskia	Jablonskia
Keayodendron	Keayodendron
Lachnostylis	Lachnostylis
Leptopus	Leptopus
Maesobotrya	Maesobotrya
Margaritaria	Margaritaria
Meineckia	Meineckia
Pentabrachion	Pentabrachion
Phyllanthopsis	Phyllanthopsis
Phyllanthus	Phyllanthus
Plagiocladus	Plagiocladus
Poranthera	Poranthera
Protomegabaria	Protomegabaria
Pseudolachnostylis	Pseudolachnostylis
Pseudophyllanthus	Pseudophyllanthus
Richeria	Richeria
Sauropus	Sauropus
Savia	Savia
Securinega	Securinega
Spondianthus	Spondianthus
Thecacoris	Thecacoris
Uapaca	Uapaca
Wielandia	Wielandia
Zimmermannia	Zimmermannia
Androstachys	Androstachys
Aristogeitonia	Aristogeitonia
Austrobuxus	Austrobuxus
Dissiliaria	Dissiliaria
Hyaenanche	Hyaenanche
Micrantheum	Micrantheum
Oldfieldia	Oldfieldia
Paradrypetes	Paradrypetes
Petalostigma	Petalostigma
Picrodendron	Picrodendron
Podocalyx	Podocalyx
Scagea	Scagea
Stachystemon	Stachystemon
Tetracoccus	Tetracoccus
Cladopus	Cladopus
Dalzellia	Dalzellia
Hydrobryum	Hydrobryum
Marathrum	Marathrum
Mourera	Mourera
Oserya	Oserya
Podostemum	Podostemum
Polypleurum	Polypleurum
Terniopsis	Terniopsis
Tristicha	Tristicha
Vanroyenella	Vanroyenella
Weddellina	Weddellina
Drypetes	Drypetes
Putranjiva	Putranjiva
Sibangea	Sibangea
Anopyxis	Anopyxis
Bruguiera	Bruguiera
Carallia	Carallia
Cassipourea	Cassipourea
Ceriops	Ceriops
Crossostylis	Crossostylis
Gynotroches	Gynotroches
Kandelia	Kandelia
Pellacalyx	Pellacalyx
Rhizophora	Rhizophora
Abatia	Abatia
Azara	Azara
Banara	Banara
Bembicia	Bembicia
Bennettiodendron	Bennettiodendron
Casearia	Casearia
Chosenia	Chosenia
Dovyalis	Dovyalis
Euceraea	Euceraea
Flacourtia	Flacourtia
Hasseltia	Hasseltia
Hasseltiopsis	Hasseltiopsis
Homalium	Homalium
Idesia	Idesia
Laetia	Laetia
Ludia	Ludia
Lunania	Lunania
Macrohasseltia	Macrohasseltia
Macrothumia	Macrothumia
Neopringlea	Neopringlea
Neoptychocarpus	Neoptychocarpus
Neosprucea	Neosprucea
Oncoba	Oncoba
Pineda	Pineda
Pleuranthodendron	Pleuranthodendron
Poliothyrsis	Poliothyrsis
Populus	Populus
Prockia	Prockia
Ryania	Ryania
Salix	Salix
Samyda	Samyda
Scolopia	Scolopia
Scyphostegia	Scyphostegia
Tetrathylacium	Tetrathylacium
Trimeria	Trimeria
Xylosma	Xylosma
Zuelania	Zuelania
Trigonia	Trigonia
Trigoniastrum	Trigoniastrum
Agation	Agation
Amphirrhox	Amphirrhox
Gloeospermum	Gloeospermum
Hybanthus	Hybanthus
Hymenanthera	Hymenanthera
Ionidium	Ionidium
Leonia	Leonia
Lophion	Lophion
Melicytus	Melicytus
Noisettia	Noisettia
Orthion	Orthion
Paypayrola	Paypayrola
Rinorea	Rinorea
Rinoreocarpus	Rinoreocarpus
Viola	Viola
Amoreuxia	Amoreuxia
Bixa	Bixa
Cochlospermum	Cochlospermum
Diegodendron	Diegodendron
Cistus	Cistus
Fumana	Fumana
Halimium	Halimium
Helianthemum	Helianthemum
Hudsonia	Hudsonia
Tuberaria	Tuberaria
Bdallophytum	Bdallophytum
Anisoptera	Anisoptera
Cotylelobium	Cotylelobium
Dipterocarpus	Dipterocarpus
Dryobalanops	Dryobalanops
Hopea	Hopea
Monotes	Monotes
Neobalanocarpus	Neobalanocarpus
Parashorea	Parashorea
Shorea	Shorea
Stemonoporus	Stemonoporus
Upuna	Upuna
Vateria	Vateria
Vateriopsis	Vateriopsis
Vatica	Vatica
Abroma	Abroma
Abutilon	Abutilon
Adansonia	Adansonia
Alcea	Alcea
Althaea	Althaea
Anisodontea	Anisodontea
Anotea	Anotea
Apeiba	Apeiba
Asterotrichion	Asterotrichion
Ayenia	Ayenia
Bakeridesia	Bakeridesia
Bastardia	Bastardia
Bastardiastrum	Bastardiastrum
Bastardiopsis	Bastardiopsis
Bernoullia	Bernoullia
Berrya	Berrya
Bombax	Bombax
Brachychiton	Brachychiton
Brownlowia	Brownlowia
Burretiodendron	Burretiodendron
Byttneria	Byttneria
Callirhoe	Callirhoe
Camptostemon	Camptostemon
Catostemma	Catostemma
Cavanillesia	Cavanillesia
Ceiba	Ceiba
Chiranthodendron	Chiranthodendron
Christiana	Christiana
Cienfuegosia	Cienfuegosia
Coelostegia	Coelostegia
Cola	Cola
Colona	Colona
Corchorus	Corchorus
Craigia	Craigia
Cristaria	Cristaria
Dombeya	Dombeya
Durio	Durio
Eremalche	Eremalche
Eriolaena	Eriolaena
Eriotheca	Eriotheca
Firmiana	Firmiana
Fremontodendron	Fremontodendron
Fuertesimalva	Fuertesimalva
Goethalsia	Goethalsia
Gossypioides	Gossypioides
Gossypium	Gossypium
Grewia	Grewia
Guazuma	Guazuma
Guichenotia	Guichenotia
Gynatrix	Gynatrix
Gyranthera	Gyranthera
Hampea	Hampea
Helicteres	Helicteres
Helicteropsis	Helicteropsis
Heliocarpus	Heliocarpus
Helmiopsiella	Helmiopsiella
Helmiopsis	Helmiopsis
Heritiera	Heritiera
Hermannia	Hermannia
Herrania	Herrania
Hibiscus	Hibiscus
Hildegardia	Hildegardia
Hoheria	Hoheria
Howittia	Howittia
Huberodendron	Huberodendron
Humbertiella	Humbertiella
Iliamna	Iliamna
Keraudrenia	Keraudrenia
Kleinhovia	Kleinhovia
Kokia	Kokia
Kosteletzkya	Kosteletzkya
Kostermansia	Kostermansia
Kydia	Kydia
Lavatera	Lavatera
Lawrencia	Lawrencia
Lebronnecia	Lebronnecia
Leptonychia	Leptonychia
Luehea	Luehea
Macrostelia	Macrostelia
Malacothamnus	Malacothamnus
Malope	Malope
Malva	Malva
Malvalthaea	Malvalthaea
Malvastrum	Malvastrum
Matisia	Matisia
Megistostegium	Megistostegium
Microcos	Microcos
Modiola	Modiola
Mortoniodendron	Mortoniodendron
Napaea	Napaea
Neesia	Neesia
Ochroma	Ochroma
Pachira	Pachira
Palaua	Palaua
Paramelhania	Paramelhania
Patinoa	Patinoa
Pavonia	Pavonia
Pentace	Pentace
Pentaplaris	Pentaplaris
Perrierophytum	Perrierophytum
Phymosia	Phymosia
Plagianthus	Plagianthus
Pseudobombax	Pseudobombax
Pterocymbium	Pterocymbium
Pterospermum	Pterospermum
Quararibea	Quararibea
Rayleya	Rayleya
Reevesia	Reevesia
Rulingia	Rulingia
Scaphium	Scaphium
Schoutenia	Schoutenia
Scleronema	Scleronema
Septotheca	Septotheca
Sida	Sida
Sidalcea	Sidalcea
Sparrmannia	Sparrmannia
Sphaeralcea	Sphaeralcea
Spirotheca	Spirotheca
Sterculia	Sterculia
Talipariti	Talipariti
Tarasa	Tarasa
Theobroma	Theobroma
Thespesia	Thespesia
Thomasia	Thomasia
Tilia	Tilia
Triplochiton	Triplochiton
Triumfetta	Triumfetta
Trochetia	Trochetia
Trochetiopsis	Trochetiopsis
Ungeria	Ungeria
Urena	Urena
Muntingia	Muntingia
Grielum	Grielum
Neurada	Neurada
Leptolaena	Leptolaena
Sarcolaena	Sarcolaena
Dialyceras	Dialyceras
Rhopalocarpus	Rhopalocarpus
Aquilaria	Aquilaria
Craterosiphon	Craterosiphon
Cryptadenia	Cryptadenia
Dais	Dais
Daphne	Daphne
Daphnopsis	Daphnopsis
Dicranolepis	Dicranolepis
Dirca	Dirca
Drapetes	Drapetes
Edgeworthia	Edgeworthia
Enkleia	Enkleia
Gnidia	Gnidia
Gonystylus	Gonystylus
Kelleria	Kelleria
Lachnaea	Lachnaea
Lethedon	Lethedon
Ovidia	Ovidia
Passerina	Passerina
Peddiea	Peddiea
Phaleria	Phaleria
Pimelea	Pimelea
Stellera	Stellera
Stephanodaphne	Stephanodaphne
Struthiola	Struthiola
Synandrodaphne	Synandrodaphne
Synaptolepis	Synaptolepis
Thecanthes	Thecanthes
Thymelaea	Thymelaea
Wikstroemia	Wikstroemia
Metteniusa	Metteniusa
Alzatea	Alzatea
Anogeissus	Anogeissus
Buchenavia	Buchenavia
Bucida	Bucida
Combretum	Combretum
Conocarpus	Conocarpus
Getonia	Getonia
Guiera	Guiera
Laguncularia	Laguncularia
Lumnitzera	Lumnitzera
Meiostemon	Meiostemon
Pteleopsis	Pteleopsis
Quisqualis	Quisqualis
Strephonema	Strephonema
Terminalia	Terminalia
Thiloa	Thiloa
Axinandra	Axinandra
Crypteronia	Crypteronia
Dactylocladus	Dactylocladus
Adenaria	Adenaria
Ammannia	Ammannia
Capuronia	Capuronia
Cuphea	Cuphea
Decodon	Decodon
Duabanga	Duabanga
Galpinia	Galpinia
Heimia	Heimia
Koehneria	Koehneria
Lafoensia	Lafoensia
Lagerstroemia	Lagerstroemia
Lawsonia	Lawsonia
Lythrum	Lythrum
Nesaea	Nesaea
Pemphis	Pemphis
Physocalymma	Physocalymma
Pleurophora	Pleurophora
Punica	Punica
Rotala	Rotala
Sonneratia	Sonneratia
Trapa	Trapa
Woodfordia	Woodfordia
Acinodendron	Acinodendron
Adelobotrys	Adelobotrys
Amphiblemma	Amphiblemma
Arthrostemma	Arthrostemma
Astronia	Astronia
Bellucia	Bellucia
Bertolonia	Bertolonia
Blakea	Blakea
Blastus	Blastus
Calvoa	Calvoa
Cambessedesia	Cambessedesia
Castratella	Castratella
Clidemia	Clidemia
Conostegia	Conostegia
Desmoscelis	Desmoscelis
Dichaetanthera	Dichaetanthera
Diplectria	Diplectria
Dissotis	Dissotis
Driessenia	Driessenia
Eriocnema	Eriocnema
Graffenrieda	Graffenrieda
Gravesia	Gravesia
Henriettea	Henriettea
Henriettella	Henriettella
Heterocentron	Heterocentron
Lavoisiera	Lavoisiera
Leandra	Leandra
Loreya	Loreya
Macrocentrum	Macrocentrum
Maieta	Maieta
Marcetia	Marcetia
Mecranium	Mecranium
Medinilla	Medinilla
Melastoma	Melastoma
Memecylon	Memecylon
Meriania	Meriania
Miconia	Miconia
Microlicia	Microlicia
Monochaetum	Monochaetum
Monolena	Monolena
Mouriri	Mouriri
Osbeckia	Osbeckia
Ossaea	Ossaea
Pternandra	Pternandra
Pterolepis	Pterolepis
Rhexia	Rhexia
Rhynchanthera	Rhynchanthera
Siphanthera	Siphanthera
Tetrazygia	Tetrazygia
Tibouchina	Tibouchina
Tococa	Tococa
Topobea	Topobea
Triolena	Triolena
Tristemma	Tristemma
Warneckea	Warneckea
Acca	Acca
Actinodium	Actinodium
Agonis	Agonis
Amomyrtus	Amomyrtus
Angasomyrtus	Angasomyrtus
Angophora	Angophora
Archirhodomyrtus	Archirhodomyrtus
Arillastrum	Arillastrum
Astartea	Astartea
Asteromyrtus	Asteromyrtus
Astus	Astus
Austromyrtus	Austromyrtus
Babingtonia	Babingtonia
Backhousia	Backhousia
Baeckea	Baeckea
Balaustion	Balaustion
Barongia	Barongia
Beaufortia	Beaufortia
Blepharocalyx	Blepharocalyx
Callistemon	Callistemon
Calothamnus	Calothamnus
Calyptranthes	Calyptranthes
Calytrix	Calytrix
Campomanesia	Campomanesia
Carpolepis	Carpolepis
Chamelaucium	Chamelaucium
Chamguava	Chamguava
Choricarpia	Choricarpia
Cloezia	Cloezia
Corymbia	Corymbia
Darwinia	Darwinia
Decaspermum	Decaspermum
Eucalyptopsis	Eucalyptopsis
Eucalyptus	Eucalyptus
Eugenia	Eugenia
Euryomyrtus	Euryomyrtus
Harmogia	Harmogia
Heteropyxis	Heteropyxis
Hexachlamys	Hexachlamys
Homalocalyx	Homalocalyx
Homalospermum	Homalospermum
Homoranthus	Homoranthus
Hypocalymma	Hypocalymma
Kardomia	Kardomia
Kjellbergiodendron	Kjellbergiodendron
Kunzea	Kunzea
Lenwebbia	Lenwebbia
Leptospermum	Leptospermum
Lindsayomyrtus	Lindsayomyrtus
Lophomyrtus	Lophomyrtus
Lophostemon	Lophostemon
Luma	Luma
Lysicarpus	Lysicarpus
Malleostemon	Malleostemon
Marlierea	Marlierea
Melaleuca	Melaleuca
Metrosideros	Metrosideros
Micromyrtus	Micromyrtus
Mosiera	Mosiera
Myrceugenia	Myrceugenia
Myrcia	Myrcia
Myrcianthes	Myrcianthes
Myrciaria	Myrciaria
Myrteola	Myrteola
Myrtus	Myrtus
Neofabricia	Neofabricia
Neomyrtus	Neomyrtus
Ochrosperma	Ochrosperma
Osbornia	Osbornia
Pericalymma	Pericalymma
Pileanthus	Pileanthus
Pilidiostigma	Pilidiostigma
Piliocalyx	Piliocalyx
Pimenta	Pimenta
Plinia	Plinia
Psidium	Psidium
Psiloxylon	Psiloxylon
Rhodamnia	Rhodamnia
Rhodomyrtus	Rhodomyrtus
Rinzia	Rinzia
Ristantia	Ristantia
Sannantha	Sannantha
Scholtzia	Scholtzia
Seorsus	Seorsus
Siphoneugena	Siphoneugena
Sphaerantia	Sphaerantia
Stockwellia	Stockwellia
Syncarpia	Syncarpia
Syzygium	Syzygium
Taxandria	Taxandria
Tepualia	Tepualia
Thaleropia	Thaleropia
Thryptomene	Thryptomene
Triplarina	Triplarina
Tristania	Tristania
Tristaniopsis	Tristaniopsis
Ugni	Ugni
Uromyrtus	Uromyrtus
Verticordia	Verticordia
Welchiodendron	Welchiodendron
Whiteodendron	Whiteodendron
Xanthostemon	Xanthostemon
Calylophus	Calylophus
Camissonia	Camissonia
Chamerion	Chamerion
Circaea	Circaea
Clarkia	Clarkia
Epilobium	Epilobium
Eulobus	Eulobus
Fuchsia	Fuchsia
Gaura	Gaura
Hauya	Hauya
Lopezia	Lopezia
Ludwigia	Ludwigia
Oenothera	Oenothera
Peniophyllum	Peniophyllum
Stenosiphon	Stenosiphon
Brachysiphon	Brachysiphon
Endonema	Endonema
Glischrocolla	Glischrocolla
Olinia	Olinia
Penaea	Penaea
Rhynchocalyx	Rhynchocalyx
Saltera	Saltera
Sonderothamnus	Sonderothamnus
Stylapterus	Stylapterus
Erisma	Erisma
Qualea	Qualea
Vochysia	Vochysia
Brasenia	Brasenia
Cabomba	Cabomba
Trithuria	Trithuria
Barclaya	Barclaya
Euryale	Euryale
Nuphar	Nuphar
Nymphaea	Nymphaea
Ondinea	Ondinea
Victoria	Victoria
Brunellia	Brunellia
Cephalotus	Cephalotus
Byrsocarpus	Byrsocarpus
Connarus	Connarus
Rourea	Rourea
Acrophyllum	Acrophyllum
Acsmithia	Acsmithia
Anodopetalum	Anodopetalum
Bauera	Bauera
Caldcluvia	Caldcluvia
Callicoma	Callicoma
Ceratopetalum	Ceratopetalum
Codia	Codia
Cunonia	Cunonia
Davidsonia	Davidsonia
Eucryphia	Eucryphia
Geissois	Geissois
Gillbeea	Gillbeea
Hooglandia	Hooglandia
Pancheria	Pancheria
Platylophus	Platylophus
Pseudoweinmannia	Pseudoweinmannia
Pullea	Pullea
Schizomeria	Schizomeria
Spiraeanthemum	Spiraeanthemum
Vesselowskya	Vesselowskya
Weinmannia	Weinmannia
Aceratium	Aceratium
Aristotelia	Aristotelia
Crinodendron	Crinodendron
Dubouzetia	Dubouzetia
Elaeocarpus	Elaeocarpus
Platytheca	Platytheca
Sloanea	Sloanea
Tetratheca	Tetratheca
Tremandra	Tremandra
Vallea	Vallea
Afrostyrax	Afrostyrax
Hua	Hua
Averrhoa	Averrhoa
Dapania	Dapania
Oxalis	Oxalis
Carludovica	Carludovica
Chorigyne	Chorigyne
Cyclanthus	Cyclanthus
Ludovia	Ludovia
Thoracocarpus	Thoracocarpus
Freycinetia	Freycinetia
Pandanus	Pandanus
Croomia	Croomia
Pentastemona	Pentastemona
Stemona	Stemona
Stichoneuron	Stichoneuron
Kupea	Kupea
Sciaphila	Sciaphila
Barbacenia	Barbacenia
Talbotia	Talbotia
Xerophyta	Xerophyta
Paracryphia	Paracryphia
Quintinia	Quintinia
Sphenostemon	Sphenostemon
Japonolirion	Japonolirion
Petrosavia	Petrosavia
Alvaradoa	Alvaradoa
Picramnia	Picramnia
Abies	Abies
Cathaya	Cathaya
Cedrus	Cedrus
Keteleeria	Keteleeria
Larix	Larix
Nothotsuga	Nothotsuga
Picea	Picea
Pinus	Pinus
Pseudolarix	Pseudolarix
Pseudotsuga	Pseudotsuga
Tsuga	Tsuga
Aristolochia	Aristolochia
Asarum	Asarum
Pararistolochia	Pararistolochia
Saruma	Saruma
Thottea	Thottea
Hydnora	Hydnora
Prosopanche	Prosopanche
Lactoris	Lactoris
Macropiper	Macropiper
Manekia	Manekia
Peperomia	Peperomia
Piper	Piper
Zippelia	Zippelia
Anemopsis	Anemopsis
Gymnotheca	Gymnotheca
Houttuynia	Houttuynia
Saururus	Saururus
Anarthria	Anarthria
Hopkinsia	Hopkinsia
Lyginia	Lyginia
Acanthostachys	Acanthostachys
Aechmea	Aechmea
Ananas	Ananas
Androlepis	Androlepis
Araeococcus	Araeococcus
Billbergia	Billbergia
Brocchinia	Brocchinia
Bromelia	Bromelia
Canistrum	Canistrum
Catopsis	Catopsis
Cottendorfia	Cottendorfia
Cryptanthus	Cryptanthus
Deuterocohnia	Deuterocohnia
Dyckia	Dyckia
Encholirium	Encholirium
Fascicularia	Fascicularia
Fernseea	Fernseea
Fosterella	Fosterella
Glomeropitcairnia	Glomeropitcairnia
Greigia	Greigia
Guzmania	Guzmania
Hechtia	Hechtia
Hohenbergia	Hohenbergia
Hohenbergiopsis	Hohenbergiopsis
Lindmania	Lindmania
Lymania	Lymania
Mezobromelia	Mezobromelia
Navia	Navia
Neoglaziovia	Neoglaziovia
Neoregelia	Neoregelia
Nidularium	Nidularium
Ochagavia	Ochagavia
Orthophytum	Orthophytum
Pitcairnia	Pitcairnia
Puya	Puya
Quesnelia	Quesnelia
Racinaea	Racinaea
Ronnbergia	Ronnbergia
Tillandsia	Tillandsia
Vriesea	Vriesea
Werauhia	Werauhia
Aphelia	Aphelia
Centrolepis	Centrolepis
Gaimardia	Gaimardia
Actinoscirpus	Actinoscirpus
Alinula	Alinula
Amphiscirpus	Amphiscirpus
Arthrostylis	Arthrostylis
Ascolepis	Ascolepis
Baumea	Baumea
Becquerelia	Becquerelia
Blysmus	Blysmus
Bolboschoenus	Bolboschoenus
Bulbostylis	Bulbostylis
Capeobolus	Capeobolus
Carex	Carex
Carpha	Carpha
Caustis	Caustis
Chorizandra	Chorizandra
Chrysitrix	Chrysitrix
Cladium	Cladium
Coleochloa	Coleochloa
Courtoisina	Courtoisina
Cyathochaeta	Cyathochaeta
Cyathocoma	Cyathocoma
Cymophyllus	Cymophyllus
Cyperus	Cyperus
Desmoschoenus	Desmoschoenus
Diplacrum	Diplacrum
Diplasia	Diplasia
Dulichium	Dulichium
Eleocharis	Eleocharis
Epischoenus	Epischoenus
Eriophorum	Eriophorum
Evandra	Evandra
Ficinia	Ficinia
Fimbristylis	Fimbristylis
Fuirena	Fuirena
Gahnia	Gahnia
Gymnoschoenus	Gymnoschoenus
Hellmuthia	Hellmuthia
Hypolytrum	Hypolytrum
Isolepis	Isolepis
Khaosokia	Khaosokia
Kobresia	Kobresia
Kyllinga	Kyllinga
Kyllingiella	Kyllingiella
Lepidosperma	Lepidosperma
Lepironia	Lepironia
Lipocarpha	Lipocarpha
Machaerina	Machaerina
Mapania	Mapania
Mesomelaena	Mesomelaena
Microdracoides	Microdracoides
Neesenbeckia	Neesenbeckia
Nemum	Nemum
Oreobolopsis	Oreobolopsis
Oreobolus	Oreobolus
Oxycaryum	Oxycaryum
Phylloscirpus	Phylloscirpus
Ptilothrix	Ptilothrix
Pycreus	Pycreus
Queenslandiella	Queenslandiella
Remirea	Remirea
Rhynchospora	Rhynchospora
Schoenoplectiella	Schoenoplectiella
Schoenoplectus	Schoenoplectus
Schoenoxiphium	Schoenoxiphium
Schoenus	Schoenus
Scirpodendron	Scirpodendron
Scirpoides	Scirpoides
Scirpus	Scirpus
Scleria	Scleria
Sphaerocyperus	Sphaerocyperus
Tetraria	Tetraria
Trachystylis	Trachystylis
Trichophorum	Trichophorum
Tricostularia	Tricostularia
Trilepis	Trilepis
Uncinia	Uncinia
Volkiella	Volkiella
Zameioscirpus	Zameioscirpus
Ecdeiocolea	Ecdeiocolea
Georgeantha	Georgeantha
Eriocaulon	Eriocaulon
Lachnocaulon	Lachnocaulon
Mesanthemum	Mesanthemum
Paepalanthus	Paepalanthus
Syngonanthus	Syngonanthus
Tonina	Tonina
Flagellaria	Flagellaria
Joinvillea	Joinvillea
Distichia	Distichia
Juncus	Juncus
Luzula	Luzula
Marsippospermum	Marsippospermum
Oxychloe	Oxychloe
Patosia	Patosia
Rostkovia	Rostkovia
Mayaca	Mayaca
Achnatherum	Achnatherum
Acrachne	Acrachne
Aegilops	Aegilops
Aegopogon	Aegopogon
Aeluropus	Aeluropus
Agropyron	Agropyron
Agrostis	Agrostis
Aira	Aira
Alloteropsis	Alloteropsis
Alopecurus	Alopecurus
Altoparadisium	Altoparadisium
Amblyopyrum	Amblyopyrum
Ammophila	Ammophila
Ampelocalamus	Ampelocalamus
Ampelodesmos	Ampelodesmos
Amphibromus	Amphibromus
Amphipogon	Amphipogon
Andropogon	Andropogon
Anisopogon	Anisopogon
Anomochloa	Anomochloa
Anthaenantiopsis	Anthaenantiopsis
Anthoxanthum	Anthoxanthum
Apera	Apera
Apluda	Apluda
Arctagrostis	Arctagrostis
Aristida	Aristida
Arrhenatherum	Arrhenatherum
Arthraxon	Arthraxon
Arthropogon	Arthropogon
Arundinaria	Arundinaria
Arundinella	Arundinella
Arundo	Arundo
Astrebla	Astrebla
Austrofestuca	Austrofestuca
Austrostipa	Austrostipa
Avena	Avena
Avenella	Avenella
Axonopus	Axonopus
Bambusa	Bambusa
Beckmannia	Beckmannia
Blepharoneuron	Blepharoneuron
Boissiera	Boissiera
Bothriochloa	Bothriochloa
Bouteloua	Bouteloua
Brachiaria	Brachiaria
Brachyelytrum	Brachyelytrum
Brachypodium	Brachypodium
Brachystachyum	Brachystachyum
Briza	Briza
Bromuniola	Bromuniola
Bromus	Bromus
Buchloe	Buchloe
Buergersiochloa	Buergersiochloa
Calamagrostis	Calamagrostis
Calamovilfa	Calamovilfa
Canastra	Canastra
Capeochloa	Capeochloa
Capillipedium	Capillipedium
Catabrosa	Catabrosa
Catapodium	Catapodium
Celtica	Celtica
Cenchrus	Cenchrus
Centotheca	Centotheca
Centropodia	Centropodia
Cephalostachyum	Cephalostachyum
Chaetobromus	Chaetobromus
Chasmanthium	Chasmanthium
Chikusichloa	Chikusichloa
Chimonobambusa	Chimonobambusa
Chionochloa	Chionochloa
Chloris	Chloris
Chondrosum	Chondrosum
Chrysopogon	Chrysopogon
Chusquea	Chusquea
Cinna	Cinna
Cladoraphis	Cladoraphis
Cleistachne	Cleistachne
Cleistogenes	Cleistogenes
Coelorachis	Coelorachis
Coix	Coix
Cortaderia	Cortaderia
Corynephorus	Corynephorus
Crithopsis	Crithopsis
Crypsis	Crypsis
Ctenium	Ctenium
Cutandia	Cutandia
Cymbopogon	Cymbopogon
Cynodon	Cynodon
Cynosurus	Cynosurus
Cyperochloa	Cyperochloa
Cyrtococcum	Cyrtococcum
Dactylis	Dactylis
Dactyloctenium	Dactyloctenium
Danthonia	Danthonia
Danthoniopsis	Danthoniopsis
Dasyochloa	Dasyochloa
Dasypyrum	Dasypyrum
Dendrocalamus	Dendrocalamus
Deschampsia	Deschampsia
Desmazeria	Desmazeria
Deyeuxia	Deyeuxia
Diarrhena	Diarrhena
Dichanthium	Dichanthium
Dichelachne	Dichelachne
Digitaria	Digitaria
Dimeria	Dimeria
Dinebra	Dinebra
Distichlis	Distichlis
Drepanostachyum	Drepanostachyum
Dryopoa	Dryopoa
Echinaria	Echinaria
Echinochloa	Echinochloa
Echinolaena	Echinolaena
Echinopogon	Echinopogon
Ectrosia	Ectrosia
Ehrharta	Ehrharta
Eleusine	Eleusine
Elymus	Elymus
Elytrophorus	Elytrophorus
Enneapogon	Enneapogon
Enteropogon	Enteropogon
Entolasia	Entolasia
Entoplocamia	Entoplocamia
Eragrostiella	Eragrostiella
Eragrostis	Eragrostis
Eremochloa	Eremochloa
Eremopyrum	Eremopyrum
Eriachne	Eriachne
Eriochloa	Eriochloa
Eulalia	Eulalia
Eustachys	Eustachys
Fargesia	Fargesia
Festuca	Festuca
Fingerhuthia	Fingerhuthia
Garnotia	Garnotia
Gastridium	Gastridium
Gaudinia	Gaudinia
Glyceria	Glyceria
Guadua	Guadua
Gymnopogon	Gymnopogon
Gynerium	Gynerium
Hackelochloa	Hackelochloa
Hainardia	Hainardia
Harpachne	Harpachne
Harpochloa	Harpochloa
Helictotrichon	Helictotrichon
Hemarthria	Hemarthria
Henrardia	Henrardia
Hesperostipa	Hesperostipa
Heterachne	Heterachne
Heteranthelium	Heteranthelium
Heteropogon	Heteropogon
Hibanobambusa	Hibanobambusa
Hierochloe	Hierochloe
Hilaria	Hilaria
Holcus	Holcus
Homolepis	Homolepis
Hordelymus	Hordelymus
Hordeum	Hordeum
Hyparrhenia	Hyparrhenia
Hyperthelia	Hyperthelia
Hystrix	Hystrix
Imperata	Imperata
Indocalamus	Indocalamus
Isachne	Isachne
Ischaemum	Ischaemum
Iseilema	Iseilema
Ixophorus	Ixophorus
Jansenella	Jansenella
Koeleria	Koeleria
Lachnagrostis	Lachnagrostis
Lagurus	Lagurus
Lamarckia	Lamarckia
Lamprothyrsus	Lamprothyrsus
Lasiacis	Lasiacis
Leersia	Leersia
Leptochloa	Leptochloa
Leptothrium	Leptothrium
Lepturus	Lepturus
Leymus	Leymus
Lintonia	Lintonia
Lithachne	Lithachne
Lolium	Lolium
Lophatherum	Lophatherum
Lycurus	Lycurus
Lygeum	Lygeum
Megastachya	Megastachya
Melanocenchris	Melanocenchris
Melica	Melica
Melinis	Melinis
Melocanna	Melocanna
Merxmuellera	Merxmuellera
Mibora	Mibora
Micraira	Micraira
Microchloa	Microchloa
Microlaena	Microlaena
Micropyrum	Micropyrum
Microstegium	Microstegium
Milium	Milium
Miscanthus	Miscanthus
Mnesithea	Mnesithea
Molinia	Molinia
Monachather	Monachather
Monanthochloe	Monanthochloe
Monelytrum	Monelytrum
Monodia	Monodia
Muhlenbergia	Muhlenbergia
Nardus	Nardus
Nassella	Nassella
Neobouteloua	Neobouteloua
Neostapfia	Neostapfia
Neurachne	Neurachne
Neuropoa	Neuropoa
Neyraudia	Neyraudia
Notochloe	Notochloe
Ocellochloa	Ocellochloa
Oligostachyum	Oligostachyum
Olyra	Olyra
Ophiochloa	Ophiochloa
Oplismenus	Oplismenus
Orcuttia	Orcuttia
Oreochloa	Oreochloa
Orinus	Orinus
Orthoclada	Orthoclada
Oryza	Oryza
Oryzopsis	Oryzopsis
Otatea	Otatea
Oxychloris	Oxychloris
Oxytenanthera	Oxytenanthera
Panicum	Panicum
Pappophorum	Pappophorum
Parapholis	Parapholis
Pariana	Pariana
Paspalidium	Paspalidium
Paspalum	Paspalum
Pennisetum	Pennisetum
Pentameris	Pentameris
Peridictyon	Peridictyon
Perotis	Perotis
Phacelurus	Phacelurus
Phaenosperma	Phaenosperma
Phalaris	Phalaris
Pharus	Pharus
Phleum	Phleum
Phragmites	Phragmites
Phyllostachys	Phyllostachys
Piptatherum	Piptatherum
Piptochaetium	Piptochaetium
Pleioblastus	Pleioblastus
Plinthanthesis	Plinthanthesis
Poa	Poa
Pogonarthria	Pogonarthria
Pogonatherum	Pogonatherum
Pohlidium	Pohlidium
Polypogon	Polypogon
Polytrias	Polytrias
Prionanthium	Prionanthium
Psammochloa	Psammochloa
Psathyrostachys	Psathyrostachys
Pseudechinolaena	Pseudechinolaena
Pseudopentameris	Pseudopentameris
Pseudopogonatherum	Pseudopogonatherum
Pseudoraphis	Pseudoraphis
Pseudoroegneria	Pseudoroegneria
Pseudosasa	Pseudosasa
Pseudosclerochloa	Pseudosclerochloa
Ptilagrostis	Ptilagrostis
Puccinellia	Puccinellia
Puelia	Puelia
Pyrrhanthera	Pyrrhanthera
Raddia	Raddia
Redfieldia	Redfieldia
Rostraria	Rostraria
Rytidosperma	Rytidosperma
Saccharum	Saccharum
Sacciolepis	Sacciolepis
Sasa	Sasa
Schedonnardus	Schedonnardus
Schismus	Schismus
Schizachne	Schizachne
Schizachyrium	Schizachyrium
Schmidtia	Schmidtia
Sclerochloa	Sclerochloa
Scleropogon	Scleropogon
Scolochloa	Scolochloa
Secale	Secale
Semiarundinaria	Semiarundinaria
Sesleria	Sesleria
Setaria	Setaria
Shibataea	Shibataea
Simplicia	Simplicia
Sitanion	Sitanion
Sorghastrum	Sorghastrum
Sorghum	Sorghum
Spartina	Spartina
Spartochloa	Spartochloa
Sphenopholis	Sphenopholis
Spinifex	Spinifex
Spodiopogon	Spodiopogon
Sporobolus	Sporobolus
Steinchisma	Steinchisma
Stenotaphrum	Stenotaphrum
Stipa	Stipa
Stipagrostis	Stipagrostis
Streblochaete	Streblochaete
Streptochaeta	Streptochaeta
Streptogyna	Streptogyna
Streptostachys	Streptostachys
Styppeiochloa	Styppeiochloa
Taeniatherum	Taeniatherum
Tatianyx	Tatianyx
Tetrachne	Tetrachne
Tetrapogon	Tetrapogon
Themeda	Themeda
Thuarea	Thuarea
Thysanolaena	Thysanolaena
Torreyochloa	Torreyochloa
Trachypogon	Trachypogon
Tragus	Tragus
Tribolium	Tribolium
Trichloris	Trichloris
Tricholaena	Tricholaena
Tridens	Tridens
Triodia	Triodia
Triplachne	Triplachne
Triplasis	Triplasis
Tripsacum	Tripsacum
Triraphis	Triraphis
Trisetum	Trisetum
Tristachya	Tristachya
Triticum	Triticum
Tuctoria	Tuctoria
Uniola	Uniola
Urochloa	Urochloa
Vaseyochloa	Vaseyochloa
Ventenata	Ventenata
Vetiveria	Vetiveria
Vulpia	Vulpia
Willkommia	Willkommia
Yushania	Yushania
Zea	Zea
Zeugites	Zeugites
Zingeria	Zingeria
Zizania	Zizania
Zizaniopsis	Zizaniopsis
Zoysia	Zoysia
Zuloagaea	Zuloagaea
Duckea	Duckea
Epidryos	Epidryos
Kunhardtia	Kunhardtia
Rapatea	Rapatea
Schoenocephalium	Schoenocephalium
Spathanthus	Spathanthus
Stegolepis	Stegolepis
Alexgeorgea	Alexgeorgea
Anthochortus	Anthochortus
Apodasmia	Apodasmia
Askidiosperma	Askidiosperma
Baloskion	Baloskion
Calopsis	Calopsis
Calorophus	Calorophus
Cannomois	Cannomois
Ceratocaryum	Ceratocaryum
Chaetanthus	Chaetanthus
Chondropetalum	Chondropetalum
Chordifex	Chordifex
Coleocarya	Coleocarya
Cytogonidium	Cytogonidium
Dapsilanthus	Dapsilanthus
Desmocladus	Desmocladus
Dielsia	Dielsia
Dovea	Dovea
Elegia	Elegia
Empodisma	Empodisma
Eurychorda	Eurychorda
Harperia	Harperia
Hydrophilus	Hydrophilus
Hypolaena	Hypolaena
Ischyrolepis	Ischyrolepis
Kulinia	Kulinia
Lepidobolus	Lepidobolus
Leptocarpus	Leptocarpus
Lepyrodia	Lepyrodia
Loxocarya	Loxocarya
Mastersiella	Mastersiella
Meeboldina	Meeboldina
Melanostachya	Melanostachya
Platycaulos	Platycaulos
Restio	Restio
Rhodocoma	Rhodocoma
Sporadanthus	Sporadanthus
Staberoha	Staberoha
Taraxis	Taraxis
Thamnochortus	Thamnochortus
Tremulina	Tremulina
Tyrbastes	Tyrbastes
Willdenowia	Willdenowia
Winifredia	Winifredia
Prionium	Prionium
Thurnia	Thurnia
Sparganium	Sparganium
Typha	Typha
Abolboda	Abolboda
Aratitiyopea	Aratitiyopea
Orectanthe	Orectanthe
Xyris	Xyris
Asplenium	Asplenium
Athyrium	Athyrium
Arachniodes	Arachniodes
Polystichum	Polystichum
Nelumbo	Nelumbo
Platanus	Platanus
Acidonia	Acidonia
Adenanthos	Adenanthos
Agastachys	Agastachys
Alloxylon	Alloxylon
Athertonia	Athertonia
Aulax	Aulax
Austromuellera	Austromuellera
Banksia	Banksia
Beauprea	Beauprea
Beaupreopsis	Beaupreopsis
Bellendena	Bellendena
Bleasdalea	Bleasdalea
Brabejum	Brabejum
Buckinghamia	Buckinghamia
Cardwellia	Cardwellia
Carnarvonia	Carnarvonia
Catalepidia	Catalepidia
Cenarrhenes	Cenarrhenes
Conospermum	Conospermum
Darlingia	Darlingia
Diastella	Diastella
Dilobeia	Dilobeia
Dryandra	Dryandra
Eidothea	Eidothea
Embothrium	Embothrium
Euplassa	Euplassa
Faurea	Faurea
Floydia	Floydia
Franklandia	Franklandia
Garnieria	Garnieria
Gevuina	Gevuina
Grevillea	Grevillea
Hakea	Hakea
Helicia	Helicia
Heliciopsis	Heliciopsis
Hicksbeachia	Hicksbeachia
Hollandaea	Hollandaea
Isopogon	Isopogon
Kermadecia	Kermadecia
Knightia	Knightia
Lambertia	Lambertia
Leucadendron	Leucadendron
Leucospermum	Leucospermum
Lomatia	Lomatia
Macadamia	Macadamia
Malagasia	Malagasia
Megahertzia	Megahertzia
Mimetes	Mimetes
Musgravea	Musgravea
Neorites	Neorites
Opisthiolepis	Opisthiolepis
Oreocallis	Oreocallis
Orites	Orites
Orothamnus	Orothamnus
Panopsis	Panopsis
Paranomus	Paranomus
Persoonia	Persoonia
Petrophile	Petrophile
Placospermum	Placospermum
Protea	Protea
Roupala	Roupala
Serruria	Serruria
Sorocephalus	Sorocephalus
Spatalla	Spatalla
Sphalmium	Sphalmium
Stenocarpus	Stenocarpus
Strangea	Strangea
Symphionema	Symphionema
Synaphea	Synaphea
Telopea	Telopea
Toronia	Toronia
Triunia	Triunia
Vexatorella	Vexatorella
Xylomelum	Xylomelum
Meliosma	Meliosma
Sabia	Sabia
Achlys	Achlys
Berberis	Berberis
Bongardia	Bongardia
Caulophyllum	Caulophyllum
Diphylleia	Diphylleia
Dysosma	Dysosma
Epimedium	Epimedium
Gymnospermium	Gymnospermium
Jeffersonia	Jeffersonia
Leontice	Leontice
Nandina	Nandina
Podophyllum	Podophyllum
Ranzania	Ranzania
Sinopodophyllum	Sinopodophyllum
Vancouveria	Vancouveria
Circaeaster	Circaeaster
Kingdonia	Kingdonia
Euptelea	Euptelea
Akebia	Akebia
Archakebia	Archakebia
Boquila	Boquila
Decaisnea	Decaisnea
Holboellia	Holboellia
Lardizabala	Lardizabala
Sargentodoxa	Sargentodoxa
Sinofranchetia	Sinofranchetia
Stauntonia	Stauntonia
Abuta	Abuta
Albertisia	Albertisia
Anamirta	Anamirta
Anisocycla	Anisocycla
Anomospermum	Anomospermum
Antizoma	Antizoma
Arcangelisia	Arcangelisia
Beirnaertia	Beirnaertia
Borismene	Borismene
Burasaia	Burasaia
Calycocarpum	Calycocarpum
Carronia	Carronia
Caryomene	Caryomene
Chasmanthera	Chasmanthera
Chondrodendron	Chondrodendron
Cissampelos	Cissampelos
Cocculus	Cocculus
Coscinium	Coscinium
Curarea	Curarea
Cyclea	Cyclea
Dioscoreophyllum	Dioscoreophyllum
Disciphania	Disciphania
Elephantomene	Elephantomene
Fibraurea	Fibraurea
Hyperbaena	Hyperbaena
Hypserpa	Hypserpa
Jateorhiza	Jateorhiza
Kolobopetalum	Kolobopetalum
Legnephora	Legnephora
Leptoterantha	Leptoterantha
Limacia	Limacia
Menispermum	Menispermum
Odontocarya	Odontocarya
Orthomene	Orthomene
Pachygone	Pachygone
Parabaena	Parabaena
Penianthus	Penianthus
Pericampylus	Pericampylus
Pycnarrhena	Pycnarrhena
Rhigiocarya	Rhigiocarya
Sarcopetalum	Sarcopetalum
Sciadotenia	Sciadotenia
Stephania	Stephania
Strychnopsis	Strychnopsis
Telitoxicum	Telitoxicum
Tiliacora	Tiliacora
Tinospora	Tinospora
Triclisia	Triclisia
Argemone	Argemone
Chelidonium	Chelidonium
Corydalis	Corydalis
Dendromecon	Dendromecon
Dicentra	Dicentra
Dicranostigma	Dicranostigma
Ehrendorferia	Ehrendorferia
Eschscholzia	Eschscholzia
Fumaria	Fumaria
Glaucium	Glaucium
Hunnemannia	Hunnemannia
Hypecoum	Hypecoum
Lamprocapnos	Lamprocapnos
Macleaya	Macleaya
Meconopsis	Meconopsis
Papaver	Papaver
Platystemon	Platystemon
Pteridophyllum	Pteridophyllum
Romneya	Romneya
Sanguinaria	Sanguinaria
Stylomecon	Stylomecon
Stylophorum	Stylophorum
Aconitum	Aconitum
Actaea	Actaea
Adonis	Adonis
Anemone	Anemone
Aquilegia	Aquilegia
Asteropyrum	Asteropyrum
Batrachium	Batrachium
Beckwithia	Beckwithia
Beesia	Beesia
Caltha	Caltha
Ceratocephala	Ceratocephala
Cimicifuga	Cimicifuga
Clematis	Clematis
Consolida	Consolida
Coptidium	Coptidium
Coptis	Coptis
Delphinium	Delphinium
Dichocarpum	Dichocarpum
Enemion	Enemion
Eranthis	Eranthis
Ficaria	Ficaria
Glaucidium	Glaucidium
Halerpestes	Halerpestes
Helleborus	Helleborus
Hepatica	Hepatica
Hydrastis	Hydrastis
Isopyrum	Isopyrum
Laccopetalum	Laccopetalum
Leptopyrum	Leptopyrum
Megaleranthis	Megaleranthis
Myosurus	Myosurus
Nigella	Nigella
Peltocalathos	Peltocalathos
Psychrophila	Psychrophila
Pulsatilla	Pulsatilla
Ranunculus	Ranunculus
Semiaquilegia	Semiaquilegia
Thalictrum	Thalictrum
Trautvetteria	Trautvetteria
Trollius	Trollius
Xanthorhiza	Xanthorhiza
Barbeya	Barbeya
Aphananthe	Aphananthe
Cannabis	Cannabis
Celtis	Celtis
Gironniera	Gironniera
Humulus	Humulus
Lozanella	Lozanella
Parasponia	Parasponia
Pteroceltis	Pteroceltis
Trema	Trema
Dirachma	Dirachma
Elaeagnus	Elaeagnus
Hippophae	Hippophae
Lepargyrea	Lepargyrea
Shepherdia	Shepherdia
Antiaris	Antiaris
Antiaropsis	Antiaropsis
Artocarpus	Artocarpus
Bagassa	Bagassa
Batocarpus	Batocarpus
Bleekrodea	Bleekrodea
Brosimum	Brosimum
Broussonetia	Broussonetia
Castilla	Castilla
Clarisia	Clarisia
Dorstenia	Dorstenia
Fatoua	Fatoua
Ficus	Ficus
Helianthostylis	Helianthostylis
Helicostylis	Helicostylis
Maclura	Maclura
Maquira	Maquira
Mesogyne	Mesogyne
Milicia	Milicia
Morus	Morus
Naucleopsis	Naucleopsis
Parartocarpus	Parartocarpus
Perebea	Perebea
Poulsenia	Poulsenia
Prainea	Prainea
Pseudolmedia	Pseudolmedia
Sorocea	Sorocea
Sparattosyce	Sparattosyce
Streblus	Streblus
Treculia	Treculia
Trophis	Trophis
Trymatococcus	Trymatococcus
Adolphia	Adolphia
Alphitonia	Alphitonia
Berchemia	Berchemia
Ceanothus	Ceanothus
Colletia	Colletia
Colubrina	Colubrina
Condalia	Condalia
Crumenaria	Crumenaria
Cryptandra	Cryptandra
Discaria	Discaria
Doerpfeldia	Doerpfeldia
Emmenosperma	Emmenosperma
Frangula	Frangula
Gouania	Gouania
Granitites	Granitites
Helinus	Helinus
Hovenia	Hovenia
Krugiodendron	Krugiodendron
Lasiodiscus	Lasiodiscus
Maesopsis	Maesopsis
Nesiota	Nesiota
Noltea	Noltea
Paliurus	Paliurus
Phylica	Phylica
Pleuranthodes	Pleuranthodes
Pomaderris	Pomaderris
Reissekia	Reissekia
Retanilla	Retanilla
Reynosia	Reynosia
Rhamnella	Rhamnella
Rhamnidium	Rhamnidium
Rhamnus	Rhamnus
Sageretia	Sageretia
Schistocarpaea	Schistocarpaea
Scutia	Scutia
Siegfriedia	Siegfriedia
Spyridium	Spyridium
Stenanthemum	Stenanthemum
Trevoa	Trevoa
Trichocephalus	Trichocephalus
Trymalium	Trymalium
Ventilago	Ventilago
Ziziphus	Ziziphus
Acaena	Acaena
Acomastylis	Acomastylis
Adenostoma	Adenostoma
Agrimonia	Agrimonia
Alchemilla	Alchemilla
Amelanchier	Amelanchier
Amygdalus	Amygdalus
Aphanes	Aphanes
Aria	Aria
Aronia	Aronia
Aruncus	Aruncus
Aucuparia	Aucuparia
Basilima	Basilima
Bossekia	Bossekia
Callionia	Callionia
Cerasus	Cerasus
Cercocarpus	Cercocarpus
Chaenomeles	Chaenomeles
Chamaebatia	Chamaebatia
Chamaerhodos	Chamaerhodos
Cliffortia	Cliffortia
Coleogyne	Coleogyne
Comarum	Comarum
Cotoneaster	Cotoneaster
Cowania	Cowania
Crataegus	Crataegus
Cydonia	Cydonia
Cylactis	Cylactis
Dasiphora	Dasiphora
Dichotomanthes	Dichotomanthes
Docynia	Docynia
Dryas	Dryas
Drymocallis	Drymocallis
Duchesnea	Duchesnea
Eriobotrya	Eriobotrya
Erythrocoma	Erythrocoma
Exochorda	Exochorda
Fallugia	Fallugia
Filipendula	Filipendula
Fragaria	Fragaria
Geum	Geum
Hagenia	Hagenia
Hesperhodos	Hesperhodos
Heteromeles	Heteromeles
Holodiscus	Holodiscus
Horkelia	Horkelia
Ivesia	Ivesia
Kageneckia	Kageneckia
Kelseya	Kelseya
Kerria	Kerria
Lachemilla	Lachemilla
Laurocerasus	Laurocerasus
Lindleya	Lindleya
Luetkea	Luetkea
Lyonothamnus	Lyonothamnus
Maddenia	Maddenia
Malacomeles	Malacomeles
Malus	Malus
Margyricarpus	Margyricarpus
Melanobatus	Melanobatus
Mespilus	Mespilus
Neillia	Neillia
Neviusia	Neviusia
Oemleria	Oemleria
Opulaster	Opulaster
Osteomeles	Osteomeles
Oxyacantha	Oxyacantha
Padus	Padus
Parageum	Parageum
Parmena	Parmena
Pentaphyllum	Pentaphyllum
Peraphyllum	Peraphyllum
Petrophytum	Petrophytum
Photinia	Photinia
Physocarpus	Physocarpus
Polylepis	Polylepis
Porteranthus	Porteranthus
Potentilla	Potentilla
Prinsepia	Prinsepia
Prunus	Prunus
Purshia	Purshia
Pygeum	Pygeum
Pyracantha	Pyracantha
Pyrus	Pyrus
Rhaphiolepis	Rhaphiolepis
Rhodotypos	Rhodotypos
Rosa	Rosa
Rubus	Rubus
Sanguisorba	Sanguisorba
Sarcopoterium	Sarcopoterium
Sibbaldia	Sibbaldia
Sorbaria	Sorbaria
Sorbus	Sorbus
Spiraea	Spiraea
Stephanandra	Stephanandra
Stranvaesia	Stranvaesia
Tridophyllum	Tridophyllum
Vauquelinia	Vauquelinia
Ampelocera	Ampelocera
Hemiptelea	Hemiptelea
Ulmus	Ulmus
Zelkova	Zelkova
Boehmeria	Boehmeria
Cecropia	Cecropia
Coussapoa	Coussapoa
Cypholophus	Cypholophus
Debregeasia	Debregeasia
Dendrocnide	Dendrocnide
Didymodoxa	Didymodoxa
Droguetia	Droguetia
Elatostema	Elatostema
Forsskaolea	Forsskaolea
Girardinia	Girardinia
Gonostegia	Gonostegia
Hesperocnide	Hesperocnide
Laportea	Laportea
Lecanthus	Lecanthus
Myriocarpa	Myriocarpa
Parietaria	Parietaria
Pellionia	Pellionia
Pilea	Pilea
Pipturus	Pipturus
Pourouma	Pourouma
Procris	Procris
Urera	Urera
Urtica	Urtica
Pilularia	Pilularia
Amphorogyne	Amphorogyne
Choretrum	Choretrum
Daenikera	Daenikera
Dendrotrophe	Dendrotrophe
Leptomeria	Leptomeria
Anacolosa	Anacolosa
Aptandra	Aptandra
Cathedra	Cathedra
Chaunochiton	Chaunochiton
Harmandia	Harmandia
Ongokea	Ongokea
Phanerodiscus	Phanerodiscus
Dactylanthus	Dactylanthus
Hachettea	Hachettea
Mystropetalon	Mystropetalon
Acanthosyris	Acanthosyris
Cervantesia	Cervantesia
Jodina	Jodina
Pilgerina	Pilgerina
Pyrularia	Pyrularia
Scleropyrum	Scleropyrum
Staufferia	Staufferia
Comandra	Comandra
Geocaulon	Geocaulon
Coula	Coula
Minquartia	Minquartia
Ochanostachys	Ochanostachys
Erythropalum	Erythropalum
Heisteria	Heisteria
Maburea	Maburea
Agelanthus	Agelanthus
Alepis	Alepis
Amyema	Amyema
Atkinsonia	Atkinsonia
Benthamina	Benthamina
Decaisnina	Decaisnina
Dendropemon	Dendropemon
Dendrophthoe	Dendrophthoe
Diplatia	Diplatia
Englerina	Englerina
Erianthemum	Erianthemum
Gaiadendron	Gaiadendron
Globimetula	Globimetula
Helixanthera	Helixanthera
Ileostylus	Ileostylus
Ligaria	Ligaria
Loranthus	Loranthus
Lysiana	Lysiana
Macrosolen	Macrosolen
Moquiniella	Moquiniella
Muellerina	Muellerina
Nuytsia	Nuytsia
Oryctanthus	Oryctanthus
Peraxilla	Peraxilla
Psittacanthus	Psittacanthus
Septulina	Septulina
Struthanthus	Struthanthus
Tapinanthus	Tapinanthus
Tristerix	Tristerix
Tupeia	Tupeia
Misodendrum	Misodendrum
Mida	Mida
Dulacia	Dulacia
Olax	Olax
Ptychopetalum	Ptychopetalum
Agonandra	Agonandra
Cansjera	Cansjera
Champereia	Champereia
Lepionurus	Lepionurus
Opilia	Opilia
Antidaphne	Antidaphne
Colpoon	Colpoon
Eubrachion	Eubrachion
Exocarpos	Exocarpos
Myoschilos	Myoschilos
Nestronia	Nestronia
Osyris	Osyris
Razoumofskya	Razoumofskya
Rhoiacarpos	Rhoiacarpos
Santalum	Santalum
Schoepfia	Schoepfia
Diogoa	Diogoa
Engomegoma	Engomegoma
Scorodocarpus	Scorodocarpus
Strombosia	Strombosia
Strombosiopsis	Strombosiopsis
Tetrastylidium	Tetrastylidium
Buckleya	Buckleya
Thesidium	Thesidium
Thesium	Thesium
Arceuthobium	Arceuthobium
Dendrophthora	Dendrophthora
Ginalloa	Ginalloa
Korthalsella	Korthalsella
Notothixos	Notothixos
Phoradendron	Phoradendron
Viscum	Viscum
Curupira	Curupira
Malania	Malania
Ximenia	Ximenia
Abrahamia	Abrahamia
Actinocheita	Actinocheita
Amphipterygium	Amphipterygium
Anacardium	Anacardium
Astronium	Astronium
Blepharocarya	Blepharocarya
Bonetiella	Bonetiella
Bouea	Bouea
Buchanania	Buchanania
Choerospondias	Choerospondias
Comocladia	Comocladia
Cotinus	Cotinus
Cyrtocarpa	Cyrtocarpa
Dracontomelon	Dracontomelon
Gluta	Gluta
Harpephyllum	Harpephyllum
Heeria	Heeria
Lannea	Lannea
Laurophyllus	Laurophyllus
Loxopterygium	Loxopterygium
Loxostylis	Loxostylis
Malosma	Malosma
Mangifera	Mangifera
Mauria	Mauria
Metopium	Metopium
Mosquitoxylum	Mosquitoxylum
Ochoterenaea	Ochoterenaea
Operculicarya	Operculicarya
Orthopterygium	Orthopterygium
Ozoroa	Ozoroa
Pachycormus	Pachycormus
Pistacia	Pistacia
Pleiogynium	Pleiogynium
Poupartia	Poupartia
Protorhus	Protorhus
Pseudosmodingium	Pseudosmodingium
Rhus	Rhus
Schinopsis	Schinopsis
Schinus	Schinus
Schmaltzia	Schmaltzia
Sclerocarya	Sclerocarya
Searsia	Searsia
Semecarpus	Semecarpus
Smodingium	Smodingium
Sorindeia	Sorindeia
Spondias	Spondias
Tapirira	Tapirira
Toxicodendron	Toxicodendron
Trichoscypha	Trichoscypha
Biebersteinia	Biebersteinia
Aucoumea	Aucoumea
Beiselia	Beiselia
Bursera	Bursera
Canarium	Canarium
Commiphora	Commiphora
Crepidospermum	Crepidospermum
Dacryodes	Dacryodes
Protium	Protium
Santiria	Santiria
Tetragastris	Tetragastris
Trattinnickia	Trattinnickia
Kirkia	Kirkia
Aglaia	Aglaia
Anthocarapa	Anthocarapa
Anthocarpa	Anthocarpa
Aphanamixis	Aphanamixis
Astrotrichilia	Astrotrichilia
Azadirachta	Azadirachta
Cabralea	Cabralea
Calodecaryia	Calodecaryia
Capuronianthus	Capuronianthus
Carapa	Carapa
Cedrela	Cedrela
Cedrelopsis	Cedrelopsis
Chisocheton	Chisocheton
Chukrasia	Chukrasia
Cipadessa	Cipadessa
Dysoxylum	Dysoxylum
Ekebergia	Ekebergia
Entandrophragma	Entandrophragma
Guarea	Guarea
Heckeldora	Heckeldora
Khaya	Khaya
Lansium	Lansium
Lepidotrichilia	Lepidotrichilia
Lovoa	Lovoa
Malleastrum	Malleastrum
Melia	Melia
Munronia	Munronia
Naregamia	Naregamia
Neobeguea	Neobeguea
Nymania	Nymania
Owenia	Owenia
Pseudobersama	Pseudobersama
Pseudocedrela	Pseudocedrela
Pseudoclausena	Pseudoclausena
Quivisianthe	Quivisianthe
Reinwardtiodendron	Reinwardtiodendron
Ruagea	Ruagea
Sandoricum	Sandoricum
Schmardaea	Schmardaea
Swietenia	Swietenia
Synoum	Synoum
Toona	Toona
Trichilia	Trichilia
Turraea	Turraea
Vavaea	Vavaea
Walsura	Walsura
Xylocarpus	Xylocarpus
Nitraria	Nitraria
Peganum	Peganum
Tetradiclis	Tetradiclis
Acmadenia	Acmadenia
Acronychia	Acronychia
Adenandra	Adenandra
Adiscanthus	Adiscanthus
Aegle	Aegle
Afraegle	Afraegle
Agathosma	Agathosma
Asterolasia	Asterolasia
Atalantia	Atalantia
Balfourodendron	Balfourodendron
Boenninghausenia	Boenninghausenia
Boronia	Boronia
Bosistoa	Bosistoa
Burkillanthus	Burkillanthus
Calodendrum	Calodendrum
Casimiroa	Casimiroa
Chloroxylon	Chloroxylon
Choisya	Choisya
Chorilaena	Chorilaena
Citropsis	Citropsis
Citrus	Citrus
Clausena	Clausena
Cneoridium	Cneoridium
Cneorum	Cneorum
Coleonema	Coleonema
Correa	Correa
Crowea	Crowea
Dictamnus	Dictamnus
Dictyoloma	Dictyoloma
Diosma	Diosma
Diplolaena	Diplolaena
Empleurum	Empleurum
Eriostemon	Eriostemon
Esenbeckia	Esenbeckia
Euchaetis	Euchaetis
Feroniella	Feroniella
Flindersia	Flindersia
Fortunella	Fortunella
Glycosmis	Glycosmis
Halfordia	Halfordia
Haplophyllum	Haplophyllum
Harrisonia	Harrisonia
Helietta	Helietta
Hortia	Hortia
Leionema	Leionema
Limonia	Limonia
Lunasia	Lunasia
Macrostylis	Macrostylis
Medicosma	Medicosma
Melicope	Melicope
Merrillia	Merrillia
Metrodorea	Metrodorea
Microcybe	Microcybe
Micromelum	Micromelum
Murraya	Murraya
Nematolepis	Nematolepis
Neochamaelea	Neochamaelea
Phebalium	Phebalium
Phellodendron	Phellodendron
Pilocarpus	Pilocarpus
Pleiospermium	Pleiospermium
Ptaeroxylon	Ptaeroxylon
Ptelea	Ptelea
Ruta	Ruta
Sarcomelicope	Sarcomelicope
Severinia	Severinia
Skimmia	Skimmia
Spathelia	Spathelia
Tetradium	Tetradium
Thamnosma	Thamnosma
Toddalia	Toddalia
Triphasia	Triphasia
Vepris	Vepris
Zanthoxylum	Zanthoxylum
Zieria	Zieria
Acer	Acer
Aesculus	Aesculus
Alectryon	Alectryon
Allophylus	Allophylus
Amesiodendron	Amesiodendron
Arfeuillea	Arfeuillea
Arytera	Arytera
Atalaya	Atalaya
Athyana	Athyana
Billia	Billia
Blighia	Blighia
Boniodendron	Boniodendron
Bottegoa	Bottegoa
Bridgesia	Bridgesia
Cardiospermum	Cardiospermum
Chytranthus	Chytranthus
Conchopetalum	Conchopetalum
Cossinia	Cossinia
Cubilia	Cubilia
Cupania	Cupania
Cupaniopsis	Cupaniopsis
Deinbollia	Deinbollia
Diatenopteryx	Diatenopteryx
Dilodendron	Dilodendron
Dimocarpus	Dimocarpus
Diploglottis	Diploglottis
Diplokeleba	Diplokeleba
Diplopeltis	Diplopeltis
Dipteronia	Dipteronia
Distichostemon	Distichostemon
Dodonaea	Dodonaea
Doratoxylon	Doratoxylon
Elattostachys	Elattostachys
Eriocoelum	Eriocoelum
Erioglossum	Erioglossum
Eurycorymbus	Eurycorymbus
Filicium	Filicium
Ganophyllum	Ganophyllum
Gloeocarpus	Gloeocarpus
Guindilia	Guindilia
Guioa	Guioa
Handeliodendron	Handeliodendron
Haplocoelopsis	Haplocoelopsis
Haplocoelum	Haplocoelum
Harpullia	Harpullia
Hebecoccus	Hebecoccus
Hippobromus	Hippobromus
Hypelate	Hypelate
Jagera	Jagera
Koelreuteria	Koelreuteria
Lecaniodiscus	Lecaniodiscus
Lepiderema	Lepiderema
Lepidopetalum	Lepidopetalum
Lepisanthes	Lepisanthes
Litchi	Litchi
Llagunoa	Llagunoa
Magonia	Magonia
Matayba	Matayba
Melicoccus	Melicoccus
Mischarytera	Mischarytera
Mischocarpus	Mischocarpus
Nephelium	Nephelium
Pancovia	Pancovia
Pappea	Pappea
Paranephelium	Paranephelium
Paullinia	Paullinia
Podonephelium	Podonephelium
Pometia	Pometia
Rhysotoechia	Rhysotoechia
Sapindus	Sapindus
Sarcopteryx	Sarcopteryx
Sarcotoechia	Sarcotoechia
Schleichera	Schleichera
Serjania	Serjania
Smelophyllum	Smelophyllum
Stadmannia	Stadmannia
Synima	Synima
Talisia	Talisia
Thouinia	Thouinia
Thouinidium	Thouinidium
Tina	Tina
Tinopsis	Tinopsis
Toechima	Toechima
Tristira	Tristira
Tristiropsis	Tristiropsis
Ungnadia	Ungnadia
Urvillea	Urvillea
Vouarana	Vouarana
Xanthoceras	Xanthoceras
Xerospermum	Xerospermum
Zanha	Zanha
Ailanthus	Ailanthus
Amaroria	Amaroria
Brucea	Brucea
Castela	Castela
Eurycoma	Eurycoma
Gymnostemon	Gymnostemon
Hannoa	Hannoa
Leitneria	Leitneria
Nothospondias	Nothospondias
Perriera	Perriera
Picrasma	Picrasma
Picrolemma	Picrolemma
Pierreodendron	Pierreodendron
Quassia	Quassia
Samadera	Samadera
Simaba	Simaba
Simarouba	Simarouba
Soulamea	Soulamea
Altingia	Altingia
Liquidambar	Liquidambar
Semiliquidambar	Semiliquidambar
Aphanopetalum	Aphanopetalum
Cercidiphyllum	Cercidiphyllum
Aeonium	Aeonium
Aichryson	Aichryson
Cotyledon	Cotyledon
Crassula	Crassula
Dudleya	Dudleya
Echeveria	Echeveria
Hylotelephium	Hylotelephium
Kalanchoe	Kalanchoe
Orostachys	Orostachys
Phedimus	Phedimus
Rhodiola	Rhodiola
Sedum	Sedum
Sempervivum	Sempervivum
Tylecodon	Tylecodon
Umbilicus	Umbilicus
Daphniphyllum	Daphniphyllum
Ribes	Ribes
Glischrocaryon	Glischrocaryon
Gonocarpus	Gonocarpus
Haloragis	Haloragis
Haloragodendron	Haloragodendron
Laurembergia	Laurembergia
Meziella	Meziella
Myriophyllum	Myriophyllum
Proserpinaca	Proserpinaca
Chunia	Chunia
Corylopsis	Corylopsis
Dicoryphe	Dicoryphe
Disanthus	Disanthus
Distyliopsis	Distyliopsis
Distylium	Distylium
Eustigma	Eustigma
Exbucklandia	Exbucklandia
Fortunearia	Fortunearia
Fothergilla	Fothergilla
Hamamelis	Hamamelis
Loropetalum	Loropetalum
Maingaya	Maingaya
Matudaea	Matudaea
Molinadendron	Molinadendron
Mytilaria	Mytilaria
Neostrearia	Neostrearia
Noahdendron	Noahdendron
Ostrearia	Ostrearia
Parrotia	Parrotia
Parrotiopsis	Parrotiopsis
Rhodoleia	Rhodoleia
Sinowilsonia	Sinowilsonia
Sycopsis	Sycopsis
Trichocladus	Trichocladus
Choristylis	Choristylis
Itea	Itea
Pterostemon	Pterostemon
Paeonia	Paeonia
Penthorum	Penthorum
Medusandra	Medusandra
Peridiscus	Peridiscus
Soyauxia	Soyauxia
Astilbe	Astilbe
Astilboides	Astilboides
Bensoniella	Bensoniella
Bergenia	Bergenia
Bolandra	Bolandra
Boykinia	Boykinia
Chrysosplenium	Chrysosplenium
Conimitella	Conimitella
Darmera	Darmera
Elmera	Elmera
Hemieva	Hemieva
Heuchera	Heuchera
Jepsonia	Jepsonia
Leptarrhena	Leptarrhena
Limnobotrya	Limnobotrya
Lithophragma	Lithophragma
Micranthes	Micranthes
Mitella	Mitella
Mukdenia	Mukdenia
Ozomelis	Ozomelis
Pectiantia	Pectiantia
Peltoboykinia	Peltoboykinia
Rodgersia	Rodgersia
Saxifraga	Saxifraga
Saxifragella	Saxifragella
Saxifragodes	Saxifragodes
Suksdorfia	Suksdorfia
Sullivantia	Sullivantia
Tanakaea	Tanakaea
Telesonix	Telesonix
Tellima	Tellima
Tiarella	Tiarella
Tolmiea	Tolmiea
Tetracarpaea	Tetracarpaea
Aniseia	Aniseia
Argyreia	Argyreia
Astripomoea	Astripomoea
Bonamia	Bonamia
Calycobolus	Calycobolus
Calystegia	Calystegia
Cardiochlamys	Cardiochlamys
Cladostigma	Cladostigma
Convolvulus	Convolvulus
Cordisepalum	Cordisepalum
Cressa	Cressa
Cuscuta	Cuscuta
Dichondra	Dichondra
Dicranostyles	Dicranostyles
Dinetus	Dinetus
Dipteropeltis	Dipteropeltis
Erycibe	Erycibe
Evolvulus	Evolvulus
Falkia	Falkia
Hewittia	Hewittia
Hildebrandtia	Hildebrandtia
Humbertia	Humbertia
Ipomoea	Ipomoea
Iseia	Iseia
Itzaea	Itzaea
Jacquemontia	Jacquemontia
Lepistemon	Lepistemon
Maripa	Maripa
Merremia	Merremia
Metaporana	Metaporana
Neuropeltis	Neuropeltis
Odonellia	Odonellia
Operculina	Operculina
Paralepistemon	Paralepistemon
Polymeria	Polymeria
Porana	Porana
Poranopsis	Poranopsis
Rapona	Rapona
Sabaudiella	Sabaudiella
Seddera	Seddera
Stictocardia	Stictocardia
Stylisma	Stylisma
Tetralocularia	Tetralocularia
Tridynamia	Tridynamia
Turbina	Turbina
Wilsonia	Wilsonia
Xenostegia	Xenostegia
Hydrolea	Hydrolea
Kaliphora	Kaliphora
Montinia	Montinia
Acnistus	Acnistus
Anthocercis	Anthocercis
Anthotroche	Anthotroche
Atropa	Atropa
Bouchetia	Bouchetia
Browallia	Browallia
Brugmansia	Brugmansia
Brunfelsia	Brunfelsia
Capsicum	Capsicum
Cestrum	Cestrum
Chamaesaracha	Chamaesaracha
Coeloneurum	Coeloneurum
Crenidium	Crenidium
Cyphanthera	Cyphanthera
Datura	Datura
Discopodium	Discopodium
Duboisia	Duboisia
Duckeodendron	Duckeodendron
Dunalia	Dunalia
Espadaea	Espadaea
Fabiana	Fabiana
Goetzea	Goetzea
Grabowskia	Grabowskia
Grammosolen	Grammosolen
Henoonia	Henoonia
Hyoscyamus	Hyoscyamus
Jaborosa	Jaborosa
Jaltomata	Jaltomata
Juanulloa	Juanulloa
Latua	Latua
Leucophysalis	Leucophysalis
Lycianthes	Lycianthes
Lycium	Lycium
Mandragora	Mandragora
Markea	Markea
Metternichia	Metternichia
Nicandra	Nicandra
Nicotiana	Nicotiana
Nierembergia	Nierembergia
Nolana	Nolana
Petunia	Petunia
Physalis	Physalis
Pionandra	Pionandra
Przewalskia	Przewalskia
Quincula	Quincula
Salpiglossis	Salpiglossis
Schizanthus	Schizanthus
Schwenckia	Schwenckia
Sessea	Sessea
Solandra	Solandra
Solanum	Solanum
Symonanthus	Symonanthus
Vassobia	Vassobia
Vestia	Vestia
Withania	Withania
Witheringia	Witheringia
Sphenoclea	Sphenoclea
Tetracentron	Tetracentron
Trochodendron	Trochodendron
Vahlia	Vahlia
Ampelocissus	Ampelocissus
Ampelopsis	Ampelopsis
Cayratia	Cayratia
Cissus	Cissus
Cyphostemma	Cyphostemma
Leea	Leea
Parthenocissus	Parthenocissus
Rhoicissus	Rhoicissus
Tetrastigma	Tetrastigma
Vitis	Vitis
Welwitschia	Welwitschia
Canna	Canna
Chamaecostus	Chamaecostus
Cheilocostus	Cheilocostus
Costus	Costus
Dimerocostus	Dimerocostus
Monocostus	Monocostus
Tapeinochilos	Tapeinochilos
Heliconia	Heliconia
Orchidantha	Orchidantha
Afrocalathea	Afrocalathea
Ataenidia	Ataenidia
Calathea	Calathea
Cominsia	Cominsia
Ctenanthe	Ctenanthe
Donax	Donax
Halopegia	Halopegia
Hylaeanthe	Hylaeanthe
Hypselodelphys	Hypselodelphys
Ischnosiphon	Ischnosiphon
Maranta	Maranta
Marantochloa	Marantochloa
Megaphrynium	Megaphrynium
Monotagma	Monotagma
Phrynium	Phrynium
Pleiostachya	Pleiostachya
Sarcophrynium	Sarcophrynium
Schumannianthus	Schumannianthus
Stachyphrynium	Stachyphrynium
Stromanthe	Stromanthe
Thalia	Thalia
Thaumatococcus	Thaumatococcus
Trachyphrynium	Trachyphrynium
Ensete	Ensete
Musa	Musa
Phenakospermum	Phenakospermum
Ravenala	Ravenala
Strelitzia	Strelitzia
Aframomum	Aframomum
Alpinia	Alpinia
Amomum	Amomum
Boesenbergia	Boesenbergia
Cautleya	Cautleya
Curcuma	Curcuma
Elettariopsis	Elettariopsis
Etlingera	Etlingera
Globba	Globba
Hedychium	Hedychium
Renealmia	Renealmia
Siphonochilus	Siphonochilus
Zingiber	Zingiber
Krameria	Krameria
Augea	Augea
Balanites	Balanites
Bulnesia	Bulnesia
Fagonia	Fagonia
Guaiacum	Guaiacum
Kallstroemia	Kallstroemia
Kelleronia	Kelleronia
Larrea	Larrea
Morkillia	Morkillia
Pintoa	Pintoa
Plectrocarpa	Plectrocarpa
Porlieria	Porlieria
Seetzenia	Seetzenia
Sisyndite	Sisyndite
Tetraena	Tetraena
Tribulus	Tribulus
Viscainoa	Viscainoa
Zygophyllum	Zygophyllum
Peltanthera	Peltanthera
Anastrophyllum	Anastrophyllum
Anemia	Anemia
Aneura	Aneura
Anomodon	Anomodon
Anthoceros	Anthoceros
Arthropteris	Arthropteris
Blasia	Blasia
Blechnum	Blechnum
Brachythecium	Brachythecium
Calymperes	Calymperes
Calypogeia	Calypogeia
Cephaloziella	Cephaloziella
Alsophila	Alsophila
Acystopteris	Acystopteris
Calochlaena	Calochlaena
Acrophorus	Acrophorus
Bolbitis	Bolbitis
Abrodictyum	Abrodictyum
Cephalomanes	Cephalomanes
Bazzania	Bazzania
Angiopteris	Angiopteris
Botrychium	Botrychium
Adenophorus	Adenophorus
Campyloneurum	Campyloneurum
Blepharostoma	Blepharostoma
Adiantum	Adiantum
Anetium	Anetium
Anogramma	Anogramma
Azolla	Azolla
Barbilophozia	Barbilophozia
Cheilanthes	Cheilanthes
Chiloscyphus	Chiloscyphus
Chrysoprenanthes	Chrysoprenanthes
Cibotium	Cibotium
Coleataenia	Coleataenia
Colysis	Colysis
Conocephalum	Conocephalum
Cordylostigma	Cordylostigma
Crepidomanes	Crepidomanes
Cryptogramma	Cryptogramma
Ctenitis	Ctenitis
Ctenopteris	Ctenopteris
Cyathea	Cyathea
Cyclonema	Cyclonema
Cyclosorus	Cyclosorus
Cyrtomium	Cyrtomium
Cystopteris	Cystopteris
Davallia	Davallia
Davilanthus	Davilanthus
Dennstaedtia	Dennstaedtia
Dicksonia	Dicksonia
Dicranopteris	Dicranopteris
Dicranum	Dicranum
Didymoglossum	Didymoglossum
Dielsiodoxa	Dielsiodoxa
Diphasiastrum	Diphasiastrum
Diplarrhena	Diplarrhena
Diplazium	Diplazium
Diplodium	Diplodium
Diplophyllum	Diplophyllum
Diplopterygium	Diplopterygium
Dipteracanthus	Dipteracanthus
Doodia	Doodia
Douglasia	Douglasia
Dryopsis	Dryopsis
Dryopteris	Dryopteris
Elaphoglossum	Elaphoglossum
Eliokarmos	Eliokarmos
Ellisochloa	Ellisochloa
Entosthodon	Entosthodon
Equisetum	Equisetum
Erythroseris	Erythroseris
Extriplex	Extriplex
Fossombronia	Fossombronia
Frullania	Frullania
Geocalyx	Geocalyx
Geochloa	Geochloa
Gleichenia	Gleichenia
Goniomitrium	Goniomitrium
Grammitis	Grammitis
Grubovia	Grubovia
Gymnocarpium	Gymnocarpium
Gymnomitrion	Gymnomitrion
Hamatocaulis	Hamatocaulis
Haplomitrium	Haplomitrium
Harpanthus	Harpanthus
Hecistopteris	Hecistopteris
Helosciadium	Helosciadium
Herbertus	Herbertus
Hesperocyparis	Hesperocyparis
Hexisea	Hexisea
Histiopteris	Histiopteris
Honkenya	Honkenya
Honorius	Honorius
Huperzia	Huperzia
Hylocomium	Hylocomium
Hymenandra	Hymenandra
Hymenasplenium	Hymenasplenium
Hymenophyllum	Hymenophyllum
Hypnum	Hypnum
Hypodematium	Hypodematium
Hypolepis	Hypolepis
Isoetes	Isoetes
Jaegerina	Jaegerina
Jarava	Jarava
Jubula	Jubula
Jungermannia	Jungermannia
Karroochloa	Karroochloa
Kurzia	Kurzia
Lasjia	Lasjia
Lastreopsis	Lastreopsis
Lejeunea	Lejeunea
Lepidozia	Lepidozia
Lepisorus	Lepisorus
Leptopteris	Leptopteris
Leptospron	Leptospron
Leucopoa	Leucopoa
Lindsaea	Lindsaea
Lithrea	Lithrea
Lomariopsis	Lomariopsis
Loncomelos	Loncomelos
Lophocolea	Lophocolea
Lophopyrum	Lophopyrum
Lophozia	Lophozia
Lunaria	Lunaria
Lunularia	Lunularia
Lycopodiella	Lycopodiella
Lycopodium	Lycopodium
Lygodium	Lygodium
Maasia	Maasia
Macrochloa	Macrochloa
Macrothelypteris	Macrothelypteris
Marattia	Marattia
Marchantia	Marchantia
Marsilea	Marsilea
Marsupella	Marsupella
Matteuccia	Matteuccia
Megathyrsus	Megathyrsus
Metzgeria	Metzgeria
Microgramma	Microgramma
Microlepia	Microlepia
Microsorum	Microsorum
Moliniopsis	Moliniopsis
Monachosorum	Monachosorum
Montitega	Montitega
Moorochloa	Moorochloa
Mylia	Mylia
Nardia	Nardia
Neoachmandra	Neoachmandra
Neocheiropteris	Neocheiropteris
Neokochia	Neokochia
Nephrolepis	Nephrolepis
Nicolaia	Nicolaia
Nicoraepoa	Nicoraepoa
Nothoalsomitra	Nothoalsomitra
Nowellia	Nowellia
Odontoschisma	Odontoschisma
Onoclea	Onoclea
Onychium	Onychium
Ophioglossum	Ophioglossum
Oreopteris	Oreopteris
Osmunda	Osmunda
Palustriella	Palustriella
Parodiophyllochloa	Parodiophyllochloa
Pedinophyllum	Pedinophyllum
Pellaea	Pellaea
Pellia	Pellia
Pepinia	Pepinia
Petagnaea	Petagnaea
Petalochilus	Petalochilus
Phaeoceros	Phaeoceros
Phegopteris	Phegopteris
Philonotis	Philonotis
Phylloglossum	Phylloglossum
Physcomitrella	Physcomitrella
Pityrogramma	Pityrogramma
Plagiochila	Plagiochila
Plagiothecium	Plagiothecium
Platycarphella	Platycarphella
Platycerium	Platycerium
Platyzoma	Platyzoma
Pleopeltis	Pleopeltis
Pleurozium	Pleurozium
Polybotrya	Polybotrya
Polyphlebium	Polyphlebium
Polypodium	Polypodium
Polytrichum	Polytrichum
Pronephrium	Pronephrium
Psilotum	Psilotum
Pteridium	Pteridium
Pteris	Pteris
Pyrrosia	Pyrrosia
Radula	Radula
Reboulia	Reboulia
Riccardia	Riccardia
Riccia	Riccia
Rohrbachia	Rohrbachia
Rubrivena	Rubrivena
Ruizia	Ruizia
Rumohra	Rumohra
Saccogyna	Saccogyna
Saccoloma	Saccoloma
Sadleria	Sadleria
Salvinia	Salvinia
Sanionia	Sanionia
Saribus	Saribus
Saxipoa	Saxipoa
Schistophyllidium	Schistophyllidium
Schizaea	Schizaea
Sedobassia	Sedobassia
Selaginella	Selaginella
Serpocaulon	Serpocaulon
Sphaeropteris	Sphaeropteris
Sphagnum	Sphagnum
Spirobassia	Spirobassia
Sticherus	Sticherus
Tectaria	Tectaria
Thelypteris	Thelypteris
Thinopyrum	Thinopyrum
Tmesipteris	Tmesipteris
Todea	Todea
Tricalistra	Tricalistra
Tricholepidium	Tricholepidium
Trichomanes	Trichomanes
Urginavia	Urginavia
Vahlodea	Vahlodea
Vandenboschia	Vandenboschia
Vitekorchis	Vitekorchis
Vittaria	Vittaria